fondled	f Q n d P d
tragical	t r { _ I k P
tiger	t 2 g @ R
ginger	_ I n _ @ R
smasher	s m { S @ R
estimate	E s t I m 1 t
feuded	f j u d I d
damnedest	d { m d I s t
palomino	p { l @ m i n 5
vacant	v 1 k @ n t
clap	k l { p
gathering	g { D @ r I N
garrison	g { r I s H
submitted	s @ b m I t I d
disdained	d I s d 1 n d
tannin	t { n I n
applique	{ p l i k 1
bevel	b E v P
swine	s w 2 n
pitied	p I t I d
clematis	k l E m @ t I s
dated	d 1 t I d
burrs	b 3 z
kopjes	k Q p I z
Bolivia	b @ l I v 7
amalgams	@ m { l g @ m z
brooks	b r U k s
ensiling	E n s 2 l I N
jotting	_ Q t I N
softlands	s Q f t l { n d z
sprinters	s p r I n t @ z
sinewy	s I n j u I
quickened	k w I k @ n d
American	@ m E r I k @ n
Tauruses	t $ r @ s I z
roughcast	r V f k # s t
browned	b r 6 n d
cohered	k 5 h 7 d
mixtures	m I k s J @ z
orthodoxy	$ T @ d Q k s I
darkened	d # k @ n d
whirled	w 3 l d
doubted	d 6 t I d
footbaths	f U t b # D z
heckle	h E k P
pardon	p # d H
choose	J u z
shaddocks	S { d @ k s
zeniths	z E n I T s
gazumping	g @ z V m p I N
crowbar	k r 5 b # R
shit	S I t
lofts	l Q f t s
oncoming	Q n k V m I N
worsen	w 3 s H
lever	l i v @ R
coat	k 5 t
visaed	v i z @ d
masses	m { s I z
merge	m 3 _
hexagrams	h E k s @ g r { m z
roasting	r $ s t I N
outstay	6 t s t 1
Gambian	g { m b 7 n
wither	w I D @ R
congenial	k @ n _ i n j @ l
latch	l { J
ninetieth	n 2 n t 7 T
push	p U S
aerates	1 @ r 1 t s
crimsoned	k r I m z H d
jujube	_ u _ u b
framework	f r 1 m w 3 k
hemming	h E m I N
jolliest	_ Q l I I s t
enshrined	I n S r 2 n d
wasters	w 1 s t @ z
slaughter	s l $ t @ R
pound	p 6 n d
burthen	b 3 D H
insinuate	I n s I n j U 1 t
screeched	s k r i J t
thinks	T I N k s
lover	l V v @ R
sparkle	s p # k P
modify	m Q d I f 2
poverty	p Q v @ t I
harmonica	h # m Q n I k @
abortive	@ b $ t I v
quoted	k w 5 t I d
flouted	f l 6 t I d
friskier	f r I s k 7 R
soothes	s u D z
numerated	n j u m @ r 1 t I d
etching	E J I N
thirst	T 3 s t
hurrahed	h U r # d
thrusting	T r V s t I N
vines	v 2 n z
moped	m 5 p t
grassed	g r # s t
jeers	_ 7 z
mortgaged	m $ g I _ d
frowst	f r 6 s t
smothered	s m V D @ d
omissions	@ m I S H z
yellow	j E l 5
workbench	w 3 k b E n J
viable	v 2 @ b P
emulous	E m j U l @ s
hoodoo	h u d u
preacher	p r i J @ R
rustles	r V s P z
reasoned	r i z H d
salt	s $ l t
crowns	k r 6 n z
here_QUOTE_re	h 7 r @ R
teethe	t i D
crocheted	k r 5 S 1 d
anther	{ n T @ R
shushes	S U S I z
chuckle	J V k P
outwore	6 t w $
galleons	g { l 7 n z
brother	b r V D @ R
deception	d I s E p S H
piranha	p I r # n j @
thankful	T { N k f U l
cope	k 5 p
mediated	m i d I 1 t I d
curried	k V r I d
consignor	k @ n s 2 n @ R
pant	p { n t
utilize	j u t @ l 2 z
inbreed	I n b r i d
amorously	{ m @ r @ s l I
licks	l I k s
cannoning	k { n @ n I N
squids	s k w I d z
cottagers	k Q t I _ @ z
adeptly	{ d E p t
robe	r 5 b
tunefully	t j u n f U l I
concerted	k @ n s 3 t I d
disrepute	d I s r I p j u t
coalholes	k 5 l h 5 l z
seining	s 1 n I N
calibre	k { l I b @ R
refresher	r I f r E S @ R
shelled	S E l d
pansy	p { n z I
yawed	j $ d
endows	I n d 6 z
hereto	h 7 t u
they_QUOTE_ll	D 1 @ l
mention	m E n S H
crouched	k r 6 J t
fiddle	f I d P
authentic	$ T E n t I k
perfume	p 3 f j u m
sheered	S 7 d
mouthed	m 6 D d
deception	d I s E p S H
chaster	J 1 s t @ R
addle	{ d P
thunder	T V n d @ R
stood	s t U d
Spartans	s p # t @ n z
sauce	s $ s
spied	s p 2 d
curled	k 3 l d
bearded	b 7 d I d
clothing	k l 5 D I N
gilding	g I l d I N
headships	h E d S I p s
listen	l I s H
arched	# J t
middled	m I d P d
enthral	I n T r $ l
butcher	b U J @ R
overplay	5 v @ p l 1
spyglass	s p 2 g l # s
defer	d I f 3 R
bouncy	b 6 n s I
material	m @ t 7 r 7 l
fathomed	f { D @ m d
hemming	h E m I N
monotony	m @ n Q t H I
freeway	f r i w 1
dabbled	d { b P d
seventh	s E v H T
handbook	h { n d b U k
jumped	_ V m p t
asphalted	{ s f { l t I d
wait	w 1 t
miscues	m I s k j u z
increase	I n k r i s
outset	6 t s E t
Quaker	k w 1 k @ R
crooks	k r U k s
puckers	p V k @ z
vitalized	v 2 t @ l 2 z d
shoehorn	S u h $ n
version	v 3 S H
either	2 D @ R
aggregate	{ g r I g 1 t
cheaper	J i p @ R
levelling	l E v P I N
nothing	n V T I N
jargon	_ # g @ n
buggy	b V g I
wince	w I n s
warms	w $ m z
firm	f 3 m
clout	k l 6 t
earshot	7 S Q t
that	D { t
stretch	s t r E J
notable	n 5 t @ b P
throats	T r 5 t s
amputee	{ m p j U t i
messages	m E s I _ I z
scrawls	s k r $ l z
garnish	g # n I S
worst	w 3 s t
growled	g r 6 l d
spears	s p 7 z
others	V D @ z
leasehold	l i s h 5 l d
shorten	S $ t H
smirch	s m 3 J
freckled	f r E k P d
pogrom	p Q g r @ m
threaded	T r E d I d
copulate	k Q p j U l 1 t
gibber	_ I b @ R
avatars	{ v @ t # z
righted	r 2 t I d
account	@ k 6 n t
nuttier	n V t 7 R
smoother	s m u D @ R
hushed	h V S t
burthens	b 3 D H z
Christian	k r I s J @ n
causal	k $ z P
polymaths	p Q l I m { T s
augury	$ g j U r I
region	r i _ @ n
carp	k # p
cowhide	k 6 h 2 d
cheeriest	J 7 r I I s t
siphons	s 2 f H z
cradled	k r 1 d P d
couth	k u T
teguments	t E g j U m @ n t s
Levant	l I v { n t
badgers	b { _ @ z
starched	s t # J t
incurred	I n k 3 d
overturn	5 v @ t 3 n
madhouse	m { d h 6 s
crabbier	k r { b 7 R
seethe	s i D
forgotten	f @ g Q t H
snaffled	s n { f P d
threes	T r i z
ruin	r U I n
warble	w $ b P
managed	m { n I _ d
shark	S # k
whitened	w 2 t H d
abos	{ b 5 z
louring	l 6 @ r I N
theatres	T 7 t @ z
clothing	k l 5 D I N
harmonies	h # m @ n I z
execute	E k s I k j u t
munched	m V n J t
promise	p r Q m I s
footnoted	f U t n 5 t I d
averring	@ v 3 r I N
histology	h I s t Q l @ _ I
declined	d I k l 2 n d
chinks	J I N k s
chocking	J Q k I N
sandstorm	s { n d s t $ m
outskirts	6 t s k 3 t s
frillier	f r I l 7 R
mother	m V D @ R
slovens	s l V v H z
reeks	r i k s
hewer	h j u @ R
waggle	w { g P
berth	b 3 T
bullfinch	b U l f I n J
ejaculate	I _ { k j U l 1 t
attract	@ t r { k t
lunchtime	l V n J t 2 m
servitors	s 3 v I t @ z
component	k @ m p 5 n @ n t
fumbles	f V m b P z
wedged	w E _ d
proffer	p r Q f @ R
metal	m E t P
disallow	d I s @ l 6
uprose	V p r 5 z
rolls	r 5 l z
underpins	V n d @ p I n z
deplaned	d i p l 1 n d
ruffed	r V f t
heard	h 3 d
dean	d i n
stumbled	s t V m b P d
enhanced	I n h # n s t
outweigh	6 t w 1
slate	s l 1 t
spoons	s p u n z
frustrate	f r V s t r 1 t
erase	I r 1 z
roadbeds	r 5 d b E d z
cyclamens	s I k l @ m @ n z
fielding	f i l d I N
grimaced	g r I m 1 s t
shored	S $ d
aqueous	1 k w 7 s
dither	d I D @ R
leaven	l E v H
tenth	t E n T
relined	r i l 2 n d
disbursed	d I s b 3 s t
fawns	f $ n z
jarred	_ # d
realized	r 7 l 2 z d
fathoms	f { D @ m z
ravened	r { v H d
scapula	s k { p j U l @
anthem	{ n T @ m
nudist	n j u d I s t
abate	@ b 1 t
patched	p { J t
Romany	r Q m @ n I
exerted	I g z 3 t I d
stirred	s t 3 d
slanting	s l # n t I N
sightseer	s 2 t s i @ R
teethe	t i D
clip	k l I p
uprose	V p r 5 z
encores	Q N k $ z
kotow	k 5 t 6
realizes	r 7 l 2 z I z
curtain	k 3 t H
Methodist	m E T @ d I s t
eschew	I s J u
forefoot	f $ f U t
raged	r 1 _ d
upstart	V p s t # t
township	t 6 n S I p
weary	w 7 r I
withheld	w I D h E l d
education	E _ U k 1 S H
unit	j u n I t
straddle	s t r { d P
moths	m Q T s
prevented	p r I v E n t I d
knock	n Q k
lamed	l 1 m d
hail	h 1 l
sentences	s E n t @ n s I z
punch	p V n J
cherish	J E r I S
oafs	5 f s
amended	@ m E n d I d
flirts	f l 3 t s
when_QUOTE_ve	w E n @ v
roofs	r u f s
syllabize	s I l @ b 2 z
floated	f l 5 t I d
unbound	V n b 6 n d
footslog	f U t s l Q g
foretop	f $ t Q p
partition	p # t I S H
weirdos	w 7 d 5 z
furthest	f 3 D I s t
bugled	b j u g P d
sixth	s I k s T
cribbage	k r I b I _
vacating	v @ k 1 t I N
maimed	m 1 m d
suffice	s @ f 2 s
cambers	k { m b @ z
fervour	f 3 v @ R
clambake	k l { m b 1 k
trowels	t r 6 @ l z
troubles	t r V b P z
doctorate	d Q k t @ r @ t
subway	s V b w 1
squallers	s k w $ l @ z
grants	g r # n t s
cheering	J 7 r I N
slithery	s l I D @ r I
heat	h i t
freshens	f r E S H z
apiaries	1 p j @ r I z
threaded	T r E d I d
crook	k r U k
perjure	p 3 _ @ R
drummer	d r V m @ R
rinses	r I n s I z
crook	k r U k
fathomed	f { D @ m d
entitling	I n t 2 t P I N
thanks	T { N k s
encircled	I n s 3 k P d
alveolars	{ l v 7 l @ z
quoted	k w 5 t I d
haricot	h { r I k 5
shoplifts	S Q p l I f t s
botanized	b Q t @ n 2 z d
dominated	d Q m I n 1 t I d
debarks	d I b # k s
requests	r I k w E s t s
paused	p $ z d
doused	d 6 s t
hortation	h $ t 1 S H
yammer	j { m @ R
unite	j u n 2 t
derange	d I r 1 n _
barmy	b # m I
council	k 6 n s P
nadirs	n 1 d 7 z
blethered	b l E D @ d
reason	r i z H
mothproof	m Q T p r u f
bookie	b U k I
gypped	_ I p t
feigned	f 1 n d
ribbed	r I b d
abate	@ b 1 t
envy	E n v I
accused	@ k j u z d
instruct	I n s t r V k t
tangiest	t { N I I s t
buffer	b V f @ R
unlearns	V n l 3 n z
belay	b I l 1
wobble	w Q b P
carry	k { r I
upgrade	V p g r 1 d
fused	f j u z d
nobble	n Q b P
filched	f I l J t
relapse	r I l { p s
bated	b 1 t I d
denier	d I n 2 @ R
sermonize	s 3 m @ n 2 z
shelduck	S E l d V k
caraway	k { r @ w 1
puffed	p V f t
cringed	k r I n _ d
vestigial	v E s t I _ 7 l
economize	I k Q n @ m 2 z
forever	f @ r E v @ R
clew	k l u
deluded	d I l u d I d
blubber	b l V b @ R
braving	b r 1 v I N
rings	r I N z
masonic	m @ s Q n I k
Dutch	d V J
wrapper	r { p @ R
maim	m 1 m
cleanup	k l i n V p
gardener	g # d n @ R
fielding	f i l d I N
duels	d j u @ l z
evicted	I v I k t I d
cholera	k Q l @ r @
gasify	g { s I f 2
roneoing	r 5 n I 5 I N
tough	t V f
encrusted	I n k r V s t I d
arrange	@ r 1 n _
born	b $ n
outbraves	6 t b r 1 v z
feathered	f E D @ d
eggheads	E g h E d z
position	p @ z I S H
throws	T r 5 z
kukri	k U k r I
sellers	s E l @ z
prejudged	p r i _ V _ d
corners	k $ n @ z
carburet	k # b j U r E t
outbrave	6 t b r 1 v
reared	r 7 d
others	V D @ z
abhorred	@ b h $ d
dictation	d I k t 1 S H
overthrow	5 v @ T r 5
hardened	h # d H d
mounts	m 6 n t s
clearing	k l 7 r I N
wreathe	r i D
uncharted	V n J # t I d
thatched	T { J t
dreadful	d r E d f U l
beam	b i m
downpour	d 6 n p $ R
Syria	s I r 7
withholds	w I D h 5 l d z
glistens	g l I s H z
tackles	t { k P z
overthrow	5 v @ T r 5
pushily	p U S I l I
fixating	f I k s 1 t I N
tank	t { N k
deject	d I _ E k t
salaam	s @ l # m
tiller	t I l @ R
donning	d Q n I N
craved	k r 1 v d
wigged	w I g d
hamstring	h { m s t r I N
tools	t u l z
rave	r 1 v
maunder	m $ n d @ R
drowsed	d r 6 z d
wristier	r I s t 7 R
blethers	b l E D @ z
pardoned	p # d H d
Fuchs	f j u k s
beach	b i J
capital	k { p I t P
throbs	T r Q b z
plentiful	p l E n t I f U l
wheedle	w i d P
labelled	l 1 b P d
museum	m j u z 7 m
gracing	g r 1 s I N
banqueted	b { N k w I t I d
churn	J 3 n
refuse	r E f j u s
degraded	d I g r 1 d I d
persuade	p @ s w 1 d
grab	g r { b
staple	s t 1 p P
duplicate	d j u p l I k @ t
dubbing	d V b I N
crocking	k r Q k I N
unbending	V n b E n d I N
cantered	k { n t @ d
slaved	s l 1 v d
walled	w $ l d
outstay	6 t s t 1
clothe	k l 5 D
exhuming	E k s h j u m I N
ravening	r { v H I N
ethics	E T I k s
cumulus	k j u m j U l @ s
condense	k @ n d E n s
bless	b l E s
mastiffs	m { s t I f s
raises	r 1 z I z
lactate	l { k t 1 t
hush	h V S
Chilean	J I l 7 n
sunburned	s V n b 3 n d
seller	s E l @ R
baking	b 1 k I N
crane	k r 1 n
regrouped	r i g r u p t
nicotine	n I k @ t i n
bullring	b U l r I N
phalanx	f { l { N k s
goatee	g 5 t i
joked	_ 5 k t
stroking	s t r 5 k I N
gridiron	g r I d 2 @ n
leotards	l i 5 t # d z
guffaw	g V f $
denounced	d I n 6 n s t
that_QUOTE_d	D { t @ d
openwork	5 p H w 3 k
Thespian	T E s p 7 n
Blimpish	b l I m p I S
ombudsman	Q m b U d z m @ n
jived	_ 2 v d
dowels	d 6 @ l z
deedpoll	d i d p 5 l
hated	h 1 t I d
cheque	J E k
slackened	s l { k @ n d
laughed	l # f t
knotted	n Q t I d
drop	d r Q p
went	w E n t
Guards	g # d z
squealers	s k w i l @ z
belay	b I l 1
only	5 n l I
surfers	s 3 f @ z
apostates	@ p Q s t 1 t s
rusk	r V s k
fastens	f # s H z
dower	d 6 @ R
implement	I m p l I m E n t
divide	d I v 2 d
become	b I k V m
lachrymal	l { k r I m P
ambling	{ m b l I N
thrift	T r I f t
pioneered	p 2 @ n 7 d
snore	s n $ R
blathered	b l { D @ d
heptagon	h E p t @ g @ n
built	b I l t
macaroon	m { k @ r u n
moaning	m 5 n I N
creakiest	k r i k I I s t
free	f r i
antidote	{ n t I d 5 t
muddled	m V d P d
dipstick	d I p s t I k
lack	l { k
peacock	p i k Q k
prejudice	p r E _ U d I s
ghettos	g E t 5 z
quilted	k w I l t I d
boodles	b u d P z
smirched	s m 3 J t
toboggan	t @ b Q g @ n
timer	t 2 m @ R
bitters	b I t @ z
subserved	s @ b s 3 v d
relenting	r I l E n t I N
sozzled	s Q z @ l d
support	s @ p $ t
further	f 3 D @ R
maidenly	m 1 d H l I
thwarted	T w $ t I d
outshines	6 t S 2 n z
here	h 7 R
mouth	m 6 D
fattened	f { t H d
quenched	k w E n J t
rethink	r i T I N k
steward	s t j U @ d
regiment	r E _ I m E n t
inflated	I n f l 1 t I d
flustered	f l V s t @ d
cant	k { n t
untangled	V n t { N g P d
equalized	i k w @ l 2 z d
barrel	b { r @ l
joggled	_ Q g P d
happening	h { p H I N
fallow	f { l 5
recurred	r I k 3 d
skulked	s k V l k t
bobbed	b Q b d
article	# t I k P
worded	w 3 d I d
hacks	h { k s
staple	s t 1 p P
wreathed	r i D d
riptides	r I p t 2 d z
borrows	b Q r 5 z
dive	d 2 v
plummet	p l V m I t
demented	d I m E n t I d
stacked	s t { k t
rustled	r V s P d
hews	h j u z
fixtures	f I k s J @ z
unbound	V n b 6 n d
carter	k # t @ R
dissuaded	d I s w 1 d I d
beat	b i t
depleted	d I p l i t I d
glowed	g l 5 d
heralds	h E r @ l d z
glint	g l I n t
sibilants	s I b I l @ n t s
whiz	w I z
finesse	f I n E s
congested	k @ n _ E s t I d
jiggered	_ I g @ d
fatigues	f @ t i g z
exculpate	E k s k V l p 1 t
pawl	p $ l
deviance	d i v 7 n s
position	p @ z I S H
amethysts	{ m I T I s t s
sputnik	s p U t n I k
battue	b { t u
routed	r 6 t I d
serenely	s I r i n l I
fortune	f $ J u n
appears	@ p 7 z
blathered	b l { D @ d
motion	m 5 S H
orthodox	$ T @ d Q k s
cook	k U k
centavos	s E n t # v 5 z
reredoses	r 7 d Q s I z
teethed	t i D d
enchain	I n J 1 n
cash	k { S
thumped	T V m p t
babyhood	b 1 b I h U d
menders	m E n d @ z
major	m 1 _ @ R
sprint	s p r I n t
tennis	t E n I s
halo	h 1 l 5
sedan	s I d { n
least	l i s t
bowing	b 6 I N
crimp	k r I m p
sewed	s 5 d
yield	j i l d
power	p 6 @ R
mandarin	m { n d @ r I n
plimsoll	p l I m s @ l
enouncing	i n 6 n s I N
grazier	g r 1 z j @ R
plotter	p l Q t @ R
plashing	p l { S I N
boxed	b Q k s t
reworded	r i w 3 d I d
scabbier	s k { b 7 R
spadefuls	s p 1 d f U l z
chickens	J I k I n z
chandlers	J # n d l @ z
tanning	t { n I N
cubits	k j u b I t s
desiring	d I z 2 @ r I N
siphon	s 2 f H
macerated	m { s @ r 1 t I d
bludgeon	b l V _ @ n
pantos	p { n t 5 z
baseboard	b 1 s b $ d
without	w I D 6 t
thwacks	T w { k s
humiliate	h j u m I l I 1 t
deplete	d I p l i t
motions	m 5 S H z
bleeped	b l i p t
engrave	I n g r 1 v
sole	s 5 l
faraway	f # r @ w 1
impacted	I m p { k t I d
grinders	g r 2 n d @ z
outsold	6 t s 5 l d
compel	k @ m p E l
curse	k 3 s
gabble	g { b P
anthrax	{ n T r { k s
efflux	E f l V k s
gush	g V S
muted	m j u t I d
silenced	s 2 l @ n s t
repeal	r I p i l
burthens	b 3 D H z
hinders	h I n d @ z
rococo	r 5 k 5 k 5
marvels	m # v P z
revel	r E v P
embrace	I m b r 1 s
milker	m I l k @ R
upgraded	V p g r 1 d I d
adored	@ d $ d
uneasier	V n i z 7 R
regulated	r E g j U l 1 t I d
ache	1 k
sundered	s V n d @ d
singed	s I n _ d
converged	k @ n v 3 _ d
journey	_ 3 n I
blasted	b l # s t I d
fiasco	f I { s k 5
sublet	s V b l E t
sagged	s { g d
vault	v $ l t
earshot	7 S Q t
betroth	b I t r 5 D
poached	p 5 J t
toothiest	t u T I I s t
stewarded	s t j U @ d I d
ocarinas	Q k @ r i n @ z
mangers	m 1 n _ @ z
struck	s t r V k
published	p V b l I S t
clobber	k l Q b @ R
assayed	@ s 1 d
shag	S { g
havering	h 1 v @ r I N
Wilton	w I l t @ n
clunked	k l V N k t
rivet	r I v I t
moreover	m $ r 5 v @ R
sneer	s n 7 R
sunbathed	s V n b 1 D d
Haitian	h 1 S H
chains	J 1 n z
thawed	T $ d
wouldn_QUOTE_t	w U d H t
argue	# g j u
bearded	b 7 d I d
bathed	b 1 D d
hunched	h V n J t
death	d E T
deputized	d E p j U t 2 z d
mussed	m V s t
milliners	m I l I n @ z
murder	m 3 d @ R
plushiest	p l V S I I s t
curtail	k 3 t 1 l
changed	J 1 n _ d
retired	r I t 2 @ d
mart	m # t
irritate	I r I t 1 t
warhorse	w $ h $ s
trouser	t r 6 z @ R
imperious	I m p 7 r 7 s
heathen	h i D H
tenthly	t E n T l I
shushed	S U S t
cardamom	k # d @ m @ m
rouses	r 6 z I z
smoothly	s m u D l I
prisoner	p r I z H @ R
chirruped	J I r @ p t
grumbled	g r V m b P d
throttle	T r Q t P
simulated	s I m j U l 1 t I d
tilled	t I l d
entombed	I n t u m d
faulted	f $ l t I d
starved	s t # v d
outranged	6 t r 1 n _ d
clumsier	k l V m z 7 R
blethers	b l E D @ z
legations	l I g 1 S H z
lychees	l 2 J i z
gunsmiths	g V n s m I T s
basketful	b # s k I t f U l
fireball	f 2 @ b $ l
compound	k @ m p 6 n d
weightier	w 1 t 7 R
weathered	w E D @ d
freshens	f r E S H z
mulches	m V l J I z
jungle	_ V N g P
plinths	p l I n T s
hoodwinks	h U d w I N k s
ketches	k E J I z
either	2 D @ R
aerate	1 @ r 1 t
Cypriots	s I p r 7 t s
Kashmiris	k { S m 7 r I z
irascibly	I r { s @ b l I
rashness	r { S n I s
fresher	f r E S @ R
buzzards	b V z @ d z
Taurus	t $ r @ s
grandaunt	g r { n d # n t
browbeat	b r 6 b i t
seasoned	s i z H d
stippled	s t I p P d
thumbed	T V m d
insular	I n s j U l @ R
journeyed	_ 3 n I d
caper	k 1 p @ R
statuette	s t { t j U E t
converts	k @ n v 3 t s
spoof	s p u f
notes	n 5 t s
arrange	@ r 1 n _
games	g 1 m z
portrays	p $ t r 1 z
arcades	# k 1 d z
tower	t 6 @ R
smothered	s m V D @ d
soften	s Q f H
miniature	m I n @ J @ R
jiggled	_ I g P d
berth	b 3 T
tattled	t { t P d
washed	w Q S t
despots	d E s p Q t s
pulsate	p V l s 1 t
shakiness	S 1 k I n I s
cock	k Q k
wilted	w I l t I d
sprouted	s p r 6 t I d
obsidian	Q b s I d 7 n
garb	g # b
riling	r 2 l I N
scuffmark	s k V f m # k
perchance	p @ J # n s
tack	t { k
outflank	6 t f l { N k
undulates	V n d j U l 1 t s
mask	m # s k
befriend	b I f r E n d
jitney	_ I t n I
flagstaff	f l { g s t # f
shores	S $ z
gather	g { D @ R
coherent	k 5 h 7 r @ n t
legation	l I g 1 S H
amethyst	{ m I T I s t
lobbyists	l Q b I I s t s
ectoplasm	E k t 5 p l { z @ m
haulier	h $ l j @ R
pyorrhoea	p 2 @ r 7
breathing	b r i D I N
evened	i v H d
puncture	p V N k J @ R
capitals	k { p I t P z
healthy	h E l T I
maturate	m { t j U r 1 t
queer	k w 7 R
strike	s t r 2 k
pale	p 1 l
grills	g r I l z
flowers	f l 6 @ z
emperor	E m p @ r @ R
gong	g Q N
pings	p I N z
trumpets	t r V m p I t s
read	r E d
baronetcy	b { r @ n I t s I
behest	b I h E s t
inrushes	I n r V S I z
empyrean	E m p 2 r i @ n
swatted	s w Q t I d
confused	k @ n f j u z d
Marxist	m # k s I s t
prong	p r Q N
snuffling	s n V f l I N
miscued	m I s k j u d
sneaking	s n i k I N
wafts	w # f t s
wall	w $ l
furnish	f 3 n I S
feathers	f E D @ z
emulsion	I m V l S H
cheerless	J 7 l I s
dangle	d { N g P
through	T r u
amputate	{ m p j U t 1 t
syringed	s I r I n _ d
marmot	m # m @ t
botch	b Q J
coupled	k V p P d
jauntiest	_ $ n t I I s t
dirk	d 3 k
counties	k 6 n t I z
dithered	d I D @ d
reddened	r E d H d
thermal	T 3 m P
doubtful	d 6 t f U l
ravioli	r { v I 5 l I
outmarch	6 t m # J
moved	m u v d
tweak	t w i k
harvested	h # v I s t I d
future	f j u J @ R
cousin	k V z H
rooked	r U k t
lioness	l 2 @ n E s
trepan	t r I p { n
told	t 5 l d
accompany	@ k V m p @ n I
dealt	d E l t
refracted	r I f r { k t I d
showery	S 6 @ r I
photon	f 5 t Q n
soaped	s 5 p t
shampoos	S { m p u z
tittered	t I t @ d
widows	w I d 5 z
bated	b 1 t I d
throes	T r 5 z
bastes	b 1 s t s
roamed	r 5 m d
cacao	k @ k # 5
anodes	{ n 5 d z
rebuilds	r i b I l d z
plotted	p l Q t I d
fitted	f I t I d
rummage	r V m I _
averred	@ v 3 d
tenant	t E n @ n t
frights	f r 2 t s
sopped	s Q p t
noose	n u s
sandbox	s { n d b Q k s
cajolery	k @ _ 5 l @ r I
underbid	V n d @ b I d
whimper	w I m p @ R
egotrips	i g 5 t r I p s
burthened	b 3 D H d
misted	m I s t I d
cromlech	k r Q m l E k
bewailed	b I w 1 l d
pawed	p $ d
caressed	k @ r E s t
cage	k 1 _
sideswipe	s 2 d s w 2 p
smelled	s m E l d
shear	S 7 R
louvred	l u v @ d
assault	@ s $ l t
slither	s l I D @ R
hosanna	h 5 z { n @
settle	s E t P
thriftily	T r I f t I l I
manumit	m { n j U m I t
service	s 3 v I s
shower	S 6 @ R
drudgery	d r V _ @ r I
impaled	I m p 1 l d
baronets	b { r @ n I t s
continued	k @ n t I n j u d
sonny	s V n I
brochures	b r 5 S @ z
clucked	k l V k t
quit	k w I t
subsidize	s V b s I d 2 z
redirect	r i d I r E k t
bacteria	b { k t 7 r 7
shafted	S # f t I d
slatier	s l 1 t 7 R
mystify	m I s t I f 2
whiffs	w I f s
dabs	d { b z
account	@ k 6 n t
casts	k # s t s
cudgelled	k V _ @ l d
solders	s Q l d @ z
auburn	$ b @ n
whether	w E D @ R
hung	h V N
jettison	_ E t I s H
choosiest	J u z I I s t
strangle	s t r { N g P
billionth	b I l j @ n T
pushy	p U S I
resettled	r i s E t P d
damns	d { m z
mentioned	m E n S H d
umpteenth	V m p t i n T
equate	I k w 1 t
fuddle	f V d P
cringe	k r I n _
rained	r 1 n d
hummed	h V m d
claim	k l 1 m
exceed	I k s i d
unloosed	V n l u s t
fibbed	f I b d
beetroot	b i t r u t
nought	n $ t
unscathed	V n s k 1 D d
statues	s t { J u z
Buddhism	b U d I z @ m
lobs	l Q b z
calendars	k { l I n d @ z
belied	b I l 2 d
encased	I n k 1 s t
pleasing	p l i z I N
unzipping	V n z I p I N
frappe	f r { p 1
combat	k Q m b { t
patterned	p { t @ n d
hauliers	h $ l j @ z
teamwork	t i m w 3 k
leather	l E D @ R
loosened	l u s H d
notch	n Q J
bethink	b I T I N k
sugarier	S U g @ r 7 R
cuttingly	k V t I N l I
actuality	{ k J U { l @ t I
gurgled	g 3 g P d
infract	I n f r { k t
confines	k @ n f 2 n z
deflated	d I f l 1 t I d
doubled	d V b P d
defer	d I f 3 R
knead	n i d
deftest	d E f t I s t
lapels	l @ p E l z
lapses	l { p s I z
solder	s Q l d @ R
reunite	r i j u n 2 t
rands	r { n d z
decontrol	d i k @ n t r 5 l
floated	f l 5 t I d
marching	m # J I N
gibbet	_ I b I t
frumps	f r V m p s
Frisbee	f r I z b I
grapnel	g r { p n P
compos	k Q m p 5 z
flyweight	f l 2 w 1 t
Doric	d Q r I k
denied	d I n 2 d
tote	t 5 t
rewarding	r I w $ d I N
dowagers	d 6 @ _ @ z
fathoms	f { D @ m z
humanizes	h j u m @ n 2 z I z
partition	p # t I S H
froth	f r Q T
wonderful	w V n d @ f U l
shako	S { k 5
prawns	p r $ n z
outvied	6 t v 2 d
loopier	l u p 7 R
fathoms	f { D @ m z
withhold	w I D h 5 l d
uneaten	V n i t H
leviathan	l I v 2 @ T H
patent	p 1 t @ n t
horseshit	h $ s S I t
journey	_ 3 n I
cows	k 6 z
idealizes	2 d 7 l 2 z I z
church	J 3 J
bathed	b # T t
evacuates	I v { k j U 1 t s
delayed	d I l 1 d
basked	b # s k t
frieze	f r i z
engenders	I n _ E n d @ z
fancy	f { n s I
adduced	@ d j u s t
possessed	p @ z E s t
pierrot	p 7 r 5
narrow	n { r 5
repotted	r i p Q t I d
shrill	S r I l
redo	r i d u
cleansed	k l E n z d
surfeits	s 3 f I t s
bandsman	b { n d z m @ n
jaundiced	_ $ n d I s t
carousal	k @ r 6 z P
gathering	g { D @ r I N
hurried	h V r I d
heartened	h # t H d
thin	T I n
evaluated	I v { l j U 1 t I d
heartened	h # t H d
pinstripe	p I n s t r 2 p
prettify	p r I t I f 2
impugned	I m p j u n d
flashed	f l { S t
diplomats	d I p l @ m { t s
label	l 1 b P
blew	b l u
bellows	b E l 5 z
snipes	s n 2 p s
cudgelled	k V _ @ l d
account	@ k 6 n t
jobbing	_ Q b I N
refill	r i f I l
abandon	@ b { n d @ n
sterns	s t 3 n z
flipping	f l I p I N
garnered	g # n @ d
fine	f 2 n
dither	d I D @ R
sailed	s 1 l d
milking	m I l k I N
dulled	d V l d
unseated	V n s i t I d
thug	T V g
shampooed	S { m p u d
dolefully	d 5 l f U l I
stored	s t $ d
spunkier	s p V N k 7 R
crunchy	k r V n J I
staked	s t 1 k t
papaws	p @ p $ z
amounts	@ m 6 n t s
bloodier	b l V d 7 R
bypaths	b 2 p # D z
nations	n 1 S H z
overarch	5 v @ r # J
piffling	p I f P I N
buckteeth	b V k t i T
populate	p Q p j U l 1 t
calling	k $ l I N
murderer	m 3 d @ r @ R
grouse	g r 6 s
besmear	b I s m 7 R
clothed	k l 5 D d
hole	h 5 l
ordinate	$ d H @ t
marchers	m # J @ z
libelled	l 2 b P d
thrust	T r V s t
bivouac	b I v U { k
turbines	t 3 b 2 n z
bughouse	b V g h 6 s
besmear	b I s m 7 R
untruths	V n t r u D z
gardened	g # d H d
ratchet	r { J I t
wobble	w Q b P
thanks	T { N k s
pullback	p U l b { k
belt	b E l t
calked	k $ k t
inertia	I n 3 S @
wound	w 6 n d
weary	w 7 r I
swathed	s w 1 D d
hiccup	h I k V p
lessons	l E s H z
chives	J 2 v z
deniable	d I n 2 @ b P
Lutheran	l u T @ r @ n
withstood	w I D s t U d
selected	s I l E k t I d
alternate	$ l t @ n 1 t
purging	p 3 _ I N
pounced	p 6 n s t
sixtieths	s I k s t 7 T s
heave	h i v
leaven	l E v H
chirruped	J I r @ p t
ambles	{ m b P z
faithful	f 1 T f U l
fatigues	f @ t i g z
slaked	s l 1 k t
firebreak	f 2 @ b r 1 k
hope	h 5 p
heretic	h E r @ t I k
thrum	T r V m
corruptly	k @ r V p t l I
compilers	k @ m p 2 l @ z
locusts	l 5 k @ s t s
decreed	d I k r i d
jollify	_ Q l I f 2
unbarring	V n b # r I N
outsider	6 t s 2 d @ R
westward	w E s t w @ d
attempted	@ t E m p t I d
approved	@ p r u v d
shake	S 1 k
crochet	k r 5 S 1
langsyne	l { N s 2 n
fate	f 1 t
acorn	1 k $ n
research	r I s 3 J
pithier	p I T 7 R
smoother	s m u D @ R
harmattan	h # m { t H
yapped	j { p t
muzzle	m V z P
spoonfuls	s p u n f U l z
anilines	{ n I l i n z
impugned	I m p j u n d
tracery	t r 1 s @ r I
foots	f U t s
sketched	s k E J t
jellied	_ E l I d
exuding	I g z j u d I N
boated	b 5 t I d
pentagon	p E n t @ g @ n
spurts	s p 3 t s
Gurkhas	g 3 k @ z
shoe	S u
antedated	{ n t I d 1 t I d
orientate	$ r I E n t 1 t
pounces	p 6 n s I z
furriers	f V r 7 z
weather	w E D @ R
orations	$ r 1 S H z
heckled	h E k P d
pounce	p 6 n s
fear	f 7 R
wreathe	r i D
raisin	r 1 z H
quenched	k w E n J t
encircled	I n s 3 k P d
regulated	r E g j U l 1 t I d
egregious	I g r i _ @ s
wedded	w E d I d
centre	s E n t @ R
savages	s { v I _ I z
trollop	t r Q l @ p
mustard	m V s t @ d
professed	p r @ f E s t
amusing	@ m j u z I N
repeat	r I p i t
decide	d I s 2 d
opening	5 p @ n I N
cremate	k r I m 1 t
morale	m Q r # l
talks	t $ k s
spouted	s p 6 t I d
sandier	s { n d 7 R
mothers	m V D @ z
students	s t j u d H t s
charcoal	J # k 5 l
puddle	p V d P
thanks	T { N k s
pulls	p U l z
reps	r E p s
rubbers	r V b @ z
short	S $ t
chirps	J 3 p s
showdowns	S 5 d 6 n z
neared	n 7 d
lathered	l # D @ d
hold	h 5 l d
reckoner	r E k H @ R
crinkled	k r I N k P d
goldsmith	g 5 l d s m I T
mistook	m I s t U k
evangels	I v { n _ E l z
rumbled	r V m b P d
tribals	t r 2 b P z
smacked	s m { k t
gecko	g E k 5
aniseed	{ n I s i d
pooh	p h u
terrorism	t E r @ r I z @ m
preachify	p r i J I f 2
senna	s E n @
zloty	z l Q t I
stride	s t r 2 d
yarn	j # n
linked	l I N k t
macs	m { k s
altered	$ l t @ d
purchased	p 3 J @ s t
frowsted	f r 6 s t I d
near	n 7 R
scythe	s 2 D
promotion	p r @ m 5 S H
theocracy	T I Q k r @ s I
peculate	p E k j U l 1 t
overtaxed	5 v @ t { k s t
adagio	@ d # _ I 5
gavotte	g @ v Q t
tailed	t 1 l d
hear	h 7 R
bestride	b I s t r 2 d
briefed	b r i f t
inculpate	I n k V l p 1 t
moors	m $ z
divergent	d 2 v 3 _ @ n t
miaouing	m i 6 I N
smoothest	s m u D I s t
caution	k $ S H
methyl	m E T I l
modular	m Q d j U l @ R
purposed	p 3 p @ s t
down	d 6 n
earmarks	7 m # k s
weathers	w E D @ z
Holiness	h 5 l I n I s
rejection	r I _ E k S H
patch	p { J
giggles	g I g P z
cloths	k l Q T s
cooking	k U k I N
bard	b # d
lopped	l Q p t
ripsaw	r I p s $
murderess	m 3 d @ r I s
outhouses	6 t h 6 z I z
domineer	d Q m I n 7 R
mother	m V D @ R
govern	g V v H
charwomen	J # w I m I n
bicycles	b 2 s I k P z
unearthed	V n 3 T t
valvular	v { l v j U l @ R
restage	r i s t 1 _
retreat	r I t r i t
armourers	# m @ r @ z
flitch	f l I J
bustled	b V s P d
living	l I v I N
etched	E J t
postulate	p Q s t j U l 1 t
sunbathed	s V n b 1 D d
staccato	s t @ k # t 5
fustiness	f V s t I n I s
oppugned	@ p j u n d
sprung	s p r V N
said	s E d
exacts	I g z { k t s
overhauls	5 v @ h $ l z
tear	t 7 R
magicians	m @ _ I S H z
plethora	p l E T @ r @
grouse	g r 6 s
fund	f V n d
expiry	I k s p 2 @ r I
decorated	d E k @ r 1 t I d
burred	b 3 d
sieve	s I v
roar	r $ R
serial	s 7 r 7 l
sunbathed	s V n b 1 D d
hotly	h Q t l I
straiten	s t r 1 t H
gambol	g { m b P
lethal	l i T P
precook	p r i k U k
fidgeted	f I _ I t I d
queer	k w 7 R
solidify	s @ l I d I f 2
thinning	T I n I N
retaliate	r I t { l I 1 t
sellotape	s E l 5 t 1 p
Calvinist	k { l v I n I s t
threshes	T r E S I z
footslogs	f U t s l Q g z
pastings	p 1 s t I N z
barbarity	b # b { r @ t I
inflame	I n f l 1 m
respect	r I s p E k t
rail	r 1 l
patent	p 1 t @ n t
embanking	I m b { N k I N
muffled	m V f P d
swap	s w Q p
bite	b 2 t
harrying	h { r I I N
hexed	h E k s t
back	b { k
jolt	_ 5 l t
omelet	Q m l I t
misused	m I s j u z d
slopes	s l 5 p s
unbend	V n b E n d
erroneous	I r 5 n j @ s
locust	l 5 k @ s t
outvoted	6 t v 5 t I d
cafe	k { f 1
donate	d 5 n 1 t
predicate	p r E d I k 1 t
foggy	f Q g I
acrid	{ k r I d
honked	h Q N k t
gibberish	_ I b @ r I S
classmate	k l # s m 1 t
crucify	k r u s I f 2
mothproof	m Q T p r u f
bloaters	b l 5 t @ z
apportion	@ p $ S H
furs	f 3 z
logarithm	l Q g @ r I D @ m
hunched	h V n J t
frugally	f r u g @ l I
pitted	p I t I d
halitosis	h { l I t 5 s I s
swell	s w E l
soused	s 6 s t
fishpaste	f I S p 1 s t
zucchini	z U k i n I
smiled	s m 2 l d
Palladio	p @ l { d I 5
slab	s l { b
sheilas	S i l @ z
upbraid	V p b r 1 d
burly	b 3 l I
augment	$ g m E n t
leathers	l E D @ z
washbasin	w Q S b 1 s H
lurched	l 3 J t
instigate	I n s t I g 1 t
pimply	p I m p l I
scar	s k # R
dottiest	d Q t I I s t
beeswaxed	b i z w { k s t
defrocks	d i f r Q k s
peasantry	p E z H t r I
tumble	t V m b P
tarry	t { r I
Sybaris	s I b @ r I s
adapted	@ d { p t I d
heartened	h # t H d
trier	t r 2 @ R
bothered	b Q D @ d
impose	I m p 5 z
staff	s t # f
clawed	k l $ d
outing	6 t I N
jaggier	_ { g 7 R
approach	@ p r 5 J
would	w U d
assurance	@ S $ r @ n s
churned	J 3 n d
workhouse	w 3 k h 6 s
nearing	n 7 r I N
bather	b 1 D @ R
auricular	$ r I k j U l @ R
chortled	J $ t P d
thrombus	T r Q m b @ s
arrange	@ r 1 n _
miscount	m I s k 6 n t
headier	h E d 7 R
leather	l E D @ R
petition	p @ t I S H
puma	p j u m @
miracles	m I r @ k P z
theorized	T 7 r 2 z d
occupied	Q k j U p 2 d
giblets	_ I b l I t s
heard	h 3 d
moused	m 6 z d
seethe	s i D
lightened	l 2 t H d
retched	r E J t
gargle	g # g P
health	h E l T
regulate	r E g j U l 1 t
bevelled	b E v P d
shrinkage	S r I N k I _
curtailed	k 3 t 1 l d
polo	p 5 l 5
rebel	r E b P
lather	l # D @ R
flayed	f l 1 d
elicit	I l I s I t
dredged	d r E _ d
parsing	p # z I N
quarrying	k w Q r I I N
Plough	p l 6
disunite	d I s j u n 2 t
frequent	f r I k w E n t
stencil	s t E n s P
closeted	k l Q z I t I d
curd	k 3 d
sublease	s V b l i s
narcissus	n # s I s @ s
envy	E n v I
nineties	n 2 n t I z
salivate	s { l I v 1 t
healed	h i l d
drolly	d r 5 l I
rootled	r u t P d
repainted	r i p 1 n t I d
homonyms	h Q m 5 n I m z
sinusitis	s 2 n @ s 2 t I s
weirdos	w 7 d 5 z
purchased	p 3 J @ s t
straggled	s t r { g P d
rewired	r i w 2 @ d
hatpins	h { t p I n z
piping	p 2 p I N
toneless	t 5 n l I s
Neptune	n E p t j u n
corundum	k @ r V n d @ m
markup	m # k V p
fault	f $ l t
bison	b 2 s H
thawed	T $ d
Wedgwood	w E _ w U d
roused	r 6 z d
near	n 7 R
smoothed	s m u D d
seventy	s E v H t I
stepchild	s t E p J 2 l d
thud	T V d
peculates	p E k j U l 1 t s
apparel	@ p { r @ l
unholy	V n h 5 l I
sprain	s p r 1 n
certify	s 3 t I f 2
shut	S V t
maundered	m $ n d @ d
hounded	h 6 n d I d
muckier	m V k 7 R
tethering	t E D @ r I N
irruption	I r V p S H
inch	I n J
atheistic	1 T I I s t I k
mournful	m $ n f U l
projector	p r @ _ E k t @ R
outcrop	6 t k r Q p
leered	l 7 d
that	D { t
fashioned	f { S H d
match	m { J
methods	m E T @ d z
tegument	t E g j U m @ n t
vomited	v Q m I t I d
cadged	k { _ d
nighties	n 2 t I z
conveners	k @ n v i n @ z
inch	I n J
handouts	h { n d 6 t s
accent	{ k s E n t
retarded	r I t # d I d
desolates	d E s @ l 1 t s
unstrung	V n s t r V N
dusting	d V s t I N
rammed	r { m d
Polly	p Q l I
curried	k V r I d
rummage	r V m I _
brownies	b r 6 n I z
soignee	s w # n j 1
berthed	b 3 T t
spiced	s p 2 s t
hostile	h Q s t 2 l
defy	d I f 2
those	D 5 z
moonlight	m u n l 2 t
grinding	g r 2 n d I N
fatiguing	f @ t i g I N
exiled	E k s 2 l d
filaments	f I l @ m @ n t s
forwarded	f $ w @ d I d
Zairean	z # 7 r 7 n
marathons	m { r @ T H z
copulate	k Q p j U l 1 t
yang	j { N
stroke	s t r 5 k
vegetable	v E _ t @ b P
travesty	t r { v @ s t I
ruin	r U I n
mollusc	m Q l @ s k
pretend	p r I t E n d
befoul	b I f 6 l
dwelt	d w E l t
radiation	r 1 d I 1 S H
amphibian	{ m f I b 7 n
nuzzle	n V z P
hyphens	h 2 f H z
strongly	s t r Q N l I
integers	I n t I _ @ z
betwixt	b I t w I k s t
possessed	p @ z E s t
hover	h Q v @ R
outrode	6 t r 5 d
chimes	J 2 m z
allergic	@ l 3 _ I k
waltz	w $ l s
that_QUOTE_s	D { t s
weeps	w i p s
recollect	r E k @ l E k t
creations	k r i 1 S H z
inked	I N k t
replicate	r E p l I k 1 t
miscarry	m I s k { r I
brain	b r 1 n
trundling	t r V n d P I N
consign	k @ n s 2 n
idealized	2 d 7 l 2 z d
char	J # R
embargo	E m b # g 5
deer	d 7 R
strayed	s t r 1 d
nosh	n Q S
accrued	@ k r u d
fattiest	f { t I I s t
sprang	s p r { N
canalized	k { n @ l 2 z d
espoused	I s p 6 z d
swindled	s w I n d P d
rule	r u l
abscesses	{ b s I s I z
collie	k Q l I
repentant	r I p E n t @ n t
ecstasy	E k s t @ s I
stuff	s t V f
bounder	b 6 n d @ R
seminar	s E m I n # R
rhetoric	r E t @ r I k
saltlick	s $ l t l I k
certified	s 3 t I f 2 d
further	f 3 D @ R
math	m { T
postulate	p Q s t j U l 1 t
coddled	k Q d P d
active	{ k t I v
megaliths	m E g @ l I T s
spilled	s p I l d
cheeking	J i k I N
pronouns	p r 5 n 6 n z
underpay	V n d @ p 1
disabled	d I s 1 b P d
barnacle	b # n @ k P
graduated	g r { d j U 1 t I d
mnemonic	n i m Q n I k
snowball	s n 5 b $ l
that	D { t
garnished	g # n I S t
mermen	m 3 m E n
foxhound	f Q k s h 6 n d
furbishes	f 3 b I S I z
feedback	f i d b { k
hexed	h E k s t
treadled	t r E d P d
queenly	k w i n l I
numbered	n V m b @ d
hinted	h I n t I d
lampooned	l { m p u n d
curtain	k 3 t H
divorce	d I v $ s
furthered	f 3 D @ d
butcher	b U J @ R
breadth	b r E t T
bludgeons	b l V _ @ n z
interview	I n t @ v j u
guardsman	g # d z m @ n
crackled	k r { k P d
moseying	m 5 z I I N
ingrained	I n g r 1 n d
jawed	_ $ d
cheer	J 7 R
withhold	w I D h 5 l d
chastened	J 1 s H d
threatens	T r E t H z
ambushed	{ m b U S t
peregrine	p E r I g r I n
Romanian	r u m 1 n j @ n
junk	_ V N k
dirtied	d 3 t I d
narrowed	n { r 5 d
overcall	5 v @ k $ l
ruddier	r V d 7 R
loathly	l 5 D l I
threads	T r E d z
hooked	h U k t
moonlit	m u n l I t
munition	m j u n I S H
marten	m # t I n
vivas	v 2 v @ z
mutilated	m j u t I l 1 t I d
rock	r Q k
genitives	_ E n I t I v z
reign	r 1 n
unseat	V n s i t
vanished	v { n I S t
calk	k $ k
orient	$ r 7 n t
soothed	s u D d
chug	J V g
deaths	d E T s
pirouette	p I r U E t
flowered	f l 6 @ d
nirvanas	n 7 v # n @ z
scythes	s 2 D z
roughened	r V f H d
champion	J { m p j @ n
thickener	T I k @ n @ R
retook	r i t U k
envisage	I n v I z I _
grade	g r 1 d
razes	r 1 z I z
broadcast	b r $ d k # s t
curs	k 3 z
playhouse	p l 1 h 6 s
query	k w 7 r I
smother	s m V D @ R
crimsons	k r I m z H z
clotures	k l 5 J @ z
fortieths	f $ t I I T s
woefully	w 5 f U l I
jollied	_ Q l I d
gurgled	g 3 g P d
outplay	6 t p l 1
realized	r 7 l 2 z d
tether	t E D @ R
govern	g V v H
arches	# J I z
thumb	T V m
formulae	f $ m j U l i
jewels	_ u @ l z
inter	I n t 3 R
plough	p l 6
impious	I m p 7 s
thine	D 2 n
leavened	l E v H d
chalky	J $ k I
wheedle	w i d P
filthier	f I l T 7 R
hood	h U d
cheapjack	J i p _ { k
thirsted	T 3 s t I d
cowskins	k 6 s k I n z
writhed	r 2 D d
widening	w 2 d H I N
abuses	@ b j u s I z
scribble	s k r I b P
actuate	{ k t j U 1 t
dredge	d r E _
whelp	w E l p
amok	@ m Q k
gravy	g r 1 v I
butt	b V t
enfeebled	I n f i b P d
visaed	v i z @ d
Catherine	k { T @ r I n
unbend	V n b E n d
sexton	s E k s t @ n
suckle	s V k P
doeskin	d 5 s k I n
personify	p @ s Q n I f 2
vexes	v E k s I z
waft	w # f t
buzz	b V z
taunt	t $ n t
avert	@ v 3 t
flourmill	f l 6 @ m I l
Cypriot	s I p r 7 t
tether	t E D @ R
deadens	d E d H z
anchovy	{ n J @ v I
subjugate	s V b _ U g 1 t
segregate	s E g r I g 1 t
quadruply	k w Q d r U p l I
furrowing	f V r 5 I N
tightened	t 2 t H d
cactus	k { k t @ s
spoke	s p 5 k
whirlwind	w 3 l w I n d
boohoo	b u h u
nuttier	n V t 7 R
naturists	n 1 J @ r I s t s
ranchers	r # n J @ z
course	k $ s
crowd	k r 6 d
then	D E n
vascular	v { s k j U l @ R
sheath	S i T
jemmied	_ E m I d
cubicles	k j u b I k P z
catfish	k { t f I S
trace	t r 1 s
duped	d j u p t
hernias	h 3 n j @ z
belittled	b I l I t P d
vocative	v Q k @ t I v
reinsured	r i I n S $ d
council	k 6 n s P
clearout	k l 7 r 6 t
seaworthy	s i w 3 D I
motion	m 5 S H
bloodbath	b l V d b # T
lounge	l 6 n _
fishcake	f I S k 1 k
ingot	I N g @ t
loamy	l 5 m I
weld	w E l d
fourteens	f $ t i n z
Bahamians	b @ h 1 m 7 n z
thus	D V s
softened	s Q f H d
chasten	J 1 s H
earth	3 T
infatuate	I n f { t j U 1 t
cogitate	k Q _ I t 1 t
shillings	S I l I N z
waterfowl	w $ t @ f 6 l
weirdness	w 7 d n I s
withstood	w I D s t U d
pouched	p 6 J t
thrillers	T r I l @ z
dodge	d Q _
solos	s 5 l 5 z
clarified	k l { r I f 2 d
cuckoo	k U k u
boated	b 5 t I d
bridge	b r I _
antecede	{ n t I s i d
cluck	k l V k
maraud	m @ r $ d
furnish	f 3 n I S
eardrums	7 d r V m z
dither	d I D @ R
fashioned	f { S H d
flinched	f l I n J t
pencil	p E n s P
earthling	3 T l I N
adhere	@ d h 7 R
profiteer	p r Q f I t 7 R
shelved	S E l v d
pissed	p I s t
pirouette	p I r U E t
pities	p I t I z
composts	k Q m p Q s t s
about	@ b 6 t
impassion	I m p { S H
guessed	g E s t
twines	t w 2 n z
undercut	V n d @ k V t
designed	d I z 2 n d
piracies	p 2 @ r @ s I z
touchily	t V J I l I
prophesy	p r Q f I s 2
outbade	6 t b 1 d
renounce	r I n 6 n s
snuggle	s n V g P
jollied	_ Q l I d
whimpers	w I m p @ z
ossifies	Q s I f 2 z
crick	k r I k
trimmest	t r I m I s t
misnomer	m I s n 5 m @ R
gnawing	n $ I N
withers	w I D @ z
importune	I m p $ t j u n
thumbing	T V m I N
burned	b 3 n d
scythe	s 2 D
inherit	I n h E r I t
condition	k @ n d I S H
extenuate	I k s t E n j U 1 t
lichgate	l I J g 1 t
spangle	s p { N g P
threesome	T r i s @ m
generates	_ E n @ r 1 t s
interlink	I n t @ l I N k
sojourn	s Q _ 3 n
twofold	t u f 5 l d
footman	f U t m @ n
slurped	s l 3 p t
schooling	s k u l I N
agitating	{ _ I t 1 t I N
Syrian	s I r 7 n
doodled	d u d P d
debriefed	d i b r i f t
wreck	r E k
situated	s I t j U 1 t I d
stoke	s t 5 k
hover	h Q v @ R
sheepskin	S i p s k I n
dismantle	d I s m { n t P
aretes	@ r E t s
recapping	r i k { p I N
hotbeds	h Q t b E d z
might	m 2 t
dramatize	d r { m @ t 2 z
shinbone	S I n b 5 n
quip	k w I p
syringed	s I r I n _ d
trustful	t r V s t f U l
gave	g 1 v
dejected	d I _ E k t I d
rippling	r I p l I N
hoovered	h u v @ d
vesper	v E s p @ R
chafe	J 1 f
cheapened	J i p @ n d
bypassed	b 2 p # s t
pleasing	p l i z I N
demoted	d i m 5 t I d
grab	g r { b
balding	b $ l d I N
fathered	f # D @ d
sevenths	s E v H T s
eyeglass	2 g l # s
grosser	g r 5 s @ R
sear	s 7 R
court	k $ t
sheathed	S i D d
orphan	$ f H
yacht	j Q t
theorized	T 7 r 2 z d
murder	m 3 d @ R
outvotes	6 t v 5 t s
clothed	k l 5 D d
pheasants	f E z H t s
fabulous	f { b j U l @ s
chicken	J I k I n
drivel	d r I v P
eightieth	1 t 7 T
jelly	_ E l I
stiffened	s t I f H d
swish	s w I S
deodorant	d i 5 d @ r @ n t
scolded	s k 5 l d I d
remainder	r I m 1 n d @ R
father	f # D @ R
burthen	b 3 D H
sleepiest	s l i p I I s t
tangle	t { N g P
inquiring	I n k w 2 @ r I N
match	m { J
gullies	g V l I z
wrote	r 5 t
flexed	f l E k s t
ossifies	Q s I f 2 z
fell	f E l
oncoming	Q n k V m I N
legion	l i _ @ n
alexic	@ l E k s I k
overspill	5 v @ s p I l
valeted	v { l I t I d
gratified	g r { t I f 2 d
crumbly	k r V m b l I
mystified	m I s t I f 2 d
timothy	t I m @ T I
hosanna	h 5 z { n @
chatter	J { t @ R
pacifier	p { s I f 2 @ R
Bowie	b 6 I
dawn	d $ n
cupid	k j u p I d
retraced	r I t r 1 s t
drive	d r 2 v
miscue	m I s k j u
jabber	_ { b @ R
shrugs	S r V g z
splodging	s p l Q _ I N
inquire	I n k w 2 @ R
hundred	h V n d r @ d
lenity	l E n @ t I
glen	g l E n
motorize	m 5 t @ r 2 z
bedded	b E d I d
upped	V p t
sneeze	s n i z
Negro	n i g r 5
mince	m I n s
inductive	I n d V k t I v
swotters	s w Q t @ z
priceless	p r 2 s l I s
trees	t r i z
edit	E d I t
misplace	m I s p l 1 s
generated	_ E n @ r 1 t I d
ropeway	r 5 p w 1
Malayans	m @ l 1 @ n z
flayed	f l 1 d
implored	I m p l $ d
disperse	d I s p 3 s
pounces	p 6 n s I z
rear	r 7 R
puzzles	p V z P z
thunder	T V n d @ R
prejudice	p r E _ U d I s
vamping	v { m p I N
gnash	n { S
moon	m u n
salad	s { l @ d
yawn	j $ n
partaking	p # t 1 k I N
burthen	b 3 D H
outnumber	6 t n V m b @ R
earmarked	7 m # k t
hiding	h 2 d I N
pasture	p # s J @ R
nickel	n I k P
fiftieth	f I f t 7 T
booklets	b U k l I t s
Chilean	J I l 7 n
empty	E m p t I
fall	f $ l
whirl	w 3 l
drown	d r 6 n
smothered	s m V D @ d
offhand	Q f h { n d
ruction	r V k S H
regulo	r E g j U l 5
addles	{ d P z
toothier	t u T 7 R
congers	k Q N g @ z
antelope	{ n t I l 5 p
faugh	f $
splurges	s p l 3 _ I z
outweigh	6 t w 1
mothered	m V D @ d
hulls	h V l z
flattens	f l { t H z
uterine	j u t @ r 2 n
truncheon	t r V n J @ n
puddled	p V d P d
throb	T r Q b
modulated	m Q d j U l 1 t I d
spied	s p 2 d
erase	I r 1 z
mania	m 1 n j @
reprimand	r E p r I m # n d
salaamed	s @ l # m d
anaconda	{ n @ k Q n d @
torsos	t $ s 5 z
spurt	s p 3 t
brownie	b r 6 n I
wreathes	r i D z
hazed	h 1 z d
garden	g # d H
ditch	d I J
frivolled	f r I v P d
footbath	f U t b # T
compound	k @ m p 6 n d
retake	r i t 1 k
tattled	t { t P d
shirts	S 3 t s
snort	s n $ t
crankier	k r { N k 7 R
seethed	s i D d
dehorned	d i h $ n d
presences	p r E z H s I z
chubbier	J V b 7 R
bathtub	b # T t V b
centuries	s E n J U r I z
unlearned	V n l 3 n d
rehoused	r i h 6 z d
further	f 3 D @ R
crescent	k r E s H t
produced	p r @ d j u s t
fizzle	f I z P
thirds	T 3 d z
simulated	s I m j U l 1 t I d
jolly	_ Q l I
triumph	t r 2 @ m f
nasality	n 1 z { l @ t I
qualify	k w Q l I f 2
precis	p r 1 s i
defectors	d I f E k t @ z
gulled	g V l d
conversed	k @ n v 3 s t
mosey	m 5 z I
stabilize	s t 1 b @ l 2 z
shook	S U k
Hesse	h E s I
elated	I l 1 t I d
embedded	I m b E d I d
tilled	t I l d
antipodes	{ n t I p @ d i z
swimmers	s w I m @ z
parrot	p { r @ t
mishandle	m I s h { n d P
protruded	p r @ t r u d I d
thatched	T { J t
broadside	b r $ d s 2 d
wound	w 6 n d
stodgier	s t Q _ 7 R
dithering	d I D @ r I N
certainty	s 3 t H t I
revivify	r i v I v I f 2
dewponds	d j u p Q n d z
snortier	s n $ t 7 R
hourglass	6 @ g l # s
algorithm	{ l g @ r I D @ m
buttons	b V t H z
fluctuate	f l V k J U 1 t
hassle	h { s P
cathartic	k @ T # t I k
hewed	h j u d
mendacity	m E n d { s @ t I
cuisine	k w I z i n
cease	s i s
soured	s 6 @ d
bamboo	b { m b u
inferred	I n f 3 d
disposal	d I s p 5 z P
devils	d E v P z
minced	m I n s t
obliged	@ b l 2 _ d
iodized	2 5 d 2 z d
overstate	5 v @ s t 1 t
chided	J 2 d I d
hurried	h V r I d
roared	r $ d
lineally	l I n 7 l I
brethren	b r E D r @ n
pardon	p # d H
throb	T r Q b
doubtful	d 6 t f U l
worsted	w 3 s t I d
mollify	m Q l I f 2
raided	r 1 d I d
idem	2 d E m
align	@ l 2 n
grumbles	g r V m b P z
ratifying	r { t I f 2 I N
coiffeurs	k w # f 3 z
hurrah	h U r #
bruised	b r u z d
stuffed	s t V f t
outlast	6 t l # s t
driblet	d r I b l I t
couth	k u T
iambi	2 { m b 2
fastens	f # s H z
healing	h i l I N
smithies	s m I D I z
prosaic	p r 5 z 1 I k
babble	b { b P
queened	k w i n d
admix	{ d m I k s
twelve	t w E l v
pallets	p { l I t s
dialled	d 2 @ l d
jagged	_ { g I d
sledding	s l E d I N
precise	p r I s 2 s
chimneys	J I m n I z
lease	l i s
indent	I n d E n t
sidestep	s 2 d s t E p
travelled	t r { v P d
fowled	f 6 l d
rankled	r { N k P d
maim	m 1 m
deported	d I p $ t I d
creosote	k r 7 s 5 t
misuse	m I s j u z
junk	_ V N k
gaffed	g { f t
atelier	@ t E l I 1
knapped	n { p t
malted	m $ l t I d
transient	t r { n z 7 n t
blethered	b l E D @ d
ravened	r { v H d
enumerate	I n j u m @ r 1 t
cheerless	J 7 l I s
earthwork	3 T w 3 k
crooked	k r U k t
outspoken	6 t s p 5 k @ n
miaowed	m i 6 d
educed	i d j u s t
sincerer	s I n s 7 r @ R
sandier	s { n d 7 R
cubing	k j u b I N
knackered	n { k @ d
mammals	m { m P z
deities	d i I t I z
darted	d # t I d
layman	l 1 m @ n
tenacity	t I n { s @ t I
teetered	t i t @ d
flounder	f l 6 n d @ R
snooped	s n u p t
rollicked	r Q l I k t
crash	k r { S
sensed	s E n s t
videos	v I d I 5 z
expose	I k s p 5 z
propose	p r @ p 5 z
bouncing	b 6 n s I N
sprained	s p r 1 n d
bloom	b l u m
Boer	b $ R
feather	f E D @ R
roughened	r V f H d
chance	J # n s
filthiest	f I l T I I s t
tuneful	t j u n f U l
mortgaged	m $ g I _ d
lathe	l 1 D
coarsened	k $ s H d
chivied	J I v I d
theocrat	T 7 k r { t
evacuate	I v { k j U 1 t
educable	E _ U k @ b P
forgather	f $ g { D @ R
unhooking	V n h U k I N
flattened	f l { t H d
pouch	p 6 J
motions	m 5 S H z
pith	p I T
trudges	t r V _ I z
loathsome	l 5 D s @ m
horseman	h $ s m @ n
watches	w Q J I z
chutes	S u t s
dethroned	d I T r 5 n d
allergies	{ l @ _ I z
kirk	k 3 k
armorial	# m $ r 7 l
thus	D V s
heronry	h E r @ n r I
cautioned	k $ S H d
communism	k Q m j U n I z @ m
achieve	@ J i v
threnody	T r E n @ d I
encourage	I n k V r I _
spurred	s p 3 d
souvenirs	s u v @ n 7 z
teethed	t i D d
hollered	h Q l @ d
gentian	_ E n S H
cranial	k r 1 n j @ l
chaw	J $
crinkled	k r I N k P d
throwaway	T r 5 @ w 1
footstep	f U t s t E p
purpler	p 3 p P @ R
bout	b 6 t
nirvanas	n 7 v # n @ z
swathed	s w 1 D d
harden	h # d H
repute	r I p j u t
chooses	J u z I z
reissued	r i I S u d
apathetic	{ p @ T E t I k
cooker	k U k @ R
savage	s { v I _
curs	k 3 z
outlasts	6 t l # s t s
besmeared	b I s m 7 d
farthest	f # D I s t
diehards	d 2 h # d z
tighten	t 2 t H
acuteness	@ k j u t n I s
chip	J I p
mumble	m V m b P
splash	s p l { S
dethrones	d I T r 5 n z
refoot	r i f U t
ingestion	I n _ E s J @ n
gybe	_ 2 b
awakened	@ w 1 k @ n d
stir	s t 3 R
orientate	$ r I E n t 1 t
downed	d 6 n d
hosiers	h 5 z 7 z
withheld	w I D h E l d
arson	# s H
pursues	p @ s j u z
finable	f 2 n @ b P
Martians	m # S H z
fourthly	f $ T l I
pushed	p U S t
curled	k 3 l d
endowing	I n d 6 I N
clear	k l 7 R
feathers	f E D @ z
continued	k @ n t I n j u d
chilled	J I l d
cancels	k { n s P z
tholes	T 5 l z
woollier	w U l 7 R
ravage	r { v I _
sophistry	s Q f I s t r I
kinking	k I N k I N
made	m 1 d
clucking	k l V k I N
foul	f 6 l
skived	s k 2 v d
hourglass	6 @ g l # s
attorn	@ t 3 n
estrange	I s t r 1 n _
master_QUOTE_s	m # s t @ z
sleetier	s l i t 7 R
coincide	k 5 I n s 2 d
sandbag	s { n d b { g
twist	t w I s t
recalled	r I k $ l d
dithered	d I D @ d
heeled	h i l d
sudden	s V d H
yacht	j Q t
champs	J { m p s
bugled	b j u g P d
anxious	{ N k S @ s
thieves	T i v z
betook	b I t U k
boarded	b $ d I d
preserved	p r I z 3 v d
clothe	k l 5 D
haft	h # f t
loosens	l u s H z
butch	b U J
pickles	p I k P z
ambush	{ m b U S
thrum	T r V m
jots	_ Q t s
collate	k @ l 1 t
palavered	p @ l # v @ d
exert	I g z 3 t
kurus	k U r U S
galled	g $ l d
aroused	@ r 6 z d
teensier	t i n z 7 R
wreaths	r i D z
homing	h 5 m I N
emissions	I m I S H z
acidulate	@ s I d j U l 1 t
captures	k { p J @ z
battle	b { t P
fourthly	f $ T l I
envisaged	I n v I z I _ d
reworded	r i w 3 d I d
doubter	d 6 t @ R
enviable	E n v 7 b P
tether	t E D @ R
headed	h E d I d
Venetian	v @ n i S H
newsflash	n j u z f l { S
branch	b r # n J
wroth	r 5 T
adjunct	{ _ V N k t
hied	h 2 d
trims	t r I m z
dumbbells	d V m b E l z
layers	l 1 @ z
piggybank	p I g I b { N k
stencil	s t E n s P
criticize	k r I t I s 2 z
jaywalked	_ 1 w $ k t
Burmese	b 3 m i z
outfitted	6 t f I t I d
Algerians	{ l _ 7 r 7 n z
smoothed	s m u D d
donations	d 5 n 1 S H z
rescues	r E s k j u z
drenches	d r E n J I z
bathed	b # T t
dowry	d 6 @ r I
drain	d r 1 n
Sicilian	s I s I l j @ n
declutch	d i k l V J
sweetens	s w i t H z
gradation	g r @ d 1 S H
shelled	S E l d
slatings	s l 1 t I N z
pouching	p 6 J I N
bream	b r i m
befriend	b I f r E n d
revolved	r I v Q l v d
snookers	s n u k @ z
extradite	E k s t r @ d 2 t
calked	k $ k t
smirked	s m 3 k t
furthered	f 3 D @ d
hastily	h 1 s t I l I
shambles	S { m b P z
therapy	T E r @ p I
capstan	k { p s t @ n
rumbles	r V m b P z
payers	p 1 @ z
links	l I N k s
lobby	l Q b I
reared	r 7 d
lockjaw	l Q k _ $
bypaths	b 2 p # D z
hive	h 2 v
modulate	m Q d j U l 1 t
leviathan	l I v 2 @ T H
bridle	b r 2 d P
whang	w { N
pipped	p I p t
addicting	@ d I k t I N
ponder	p Q n d @ R
league	l i g
pearlier	p 3 l 7 R
overhead	5 v @ h E d
quartet	k w $ t E t
scoured	s k 6 @ d
smother	s m V D @ R
Yemenis	j E m @ n I z
hunched	h V n J t
beneath	b I n i T
workrooms	w 3 k r U m z
Virginia	v @ _ I n j @
shrink	S r I N k
sent	s E n t
pike	p 2 k
renames	r i n 1 m z
cites	s 2 t s
inducted	I n d V k t I d
curtained	k 3 t H d
adorned	@ d $ n d
scowled	s k 6 l d
summerier	s V m @ r 7 R
withstand	w I D s t { n d
stanched	s t # n J t
crinkle	k r I N k P
thank	T { N k
simulated	s I m j U l 1 t I d
largest	l # _ I s t
chaps	J { p s
raspberry	r # z b @ r I
Paraclete	p { r @ k l i t
climax	k l 2 m { k s
fined	f 2 n d
liquefied	l I k w I f 2 d
silences	s 2 l @ n s I z
succumb	s @ k V m
madhouse	m { d h 6 s
worship	w 3 S I p
decode	d i k 5 d
rejected	r I _ E k t I d
high	h 2
aurally	$ r @ l I
inferiors	I n f 7 r 7 z
withheld	w I D h E l d
woodenly	w U d H l I
ripple	r I p P
thrill	T r I l
jilt	_ I l t
torques	t $ k s
outed	6 t I d
withheld	w I D h E l d
gladdened	g l { d H d
Canadian	k @ n 1 d j @ n
checkers	J E k @ z
spangled	s p { N g P d
math	m { T
would	w U d
bristle	b r I s P
unhand	V n h { n d
renew	r I n j u
bankers	b { N k @ z
blasted	b l # s t I d
induced	I n d j u s t
peppered	p E p @ d
governed	g V v H d
ravished	r { v I S t
skyward	s k 2 w @ d
whimpered	w I m p @ d
wandered	w Q n d @ d
clash	k l { S
lionize	l 2 @ n 2 z
tickled	t I k P d
potable	p 5 t @ b P
Whitsun	w I t s H
offering	Q f @ r I N
peeved	p i v d
encumbers	I n k V m b @ z
clamp	k l { m p
succumb	s @ k V m
abhorrent	@ b h Q r @ n t
dearer	d 7 r @ R
envyingly	E n v I I N l I
millet	m I l I t
power	p 6 @ R
necklace	n E k l I s
reverse	r I v 3 s
wires	w 2 @ z
cool	k u l
hotpot	h Q t p Q t
reproofed	r i p r u f t
tensing	t E n s I N
mustiness	m V s t I n I s
carried	k { r I d
unkinder	V n k 2 n d @ R
arrest	@ r E s t
blanket	b l { N k I t
caboodle	k @ b u d P
profess	p r @ f E s
postured	p Q s J @ d
abrade	@ b r 1 d
jump	_ V m p
bedsides	b E d s 2 d z
puzzle	p V z P
reckons	r E k @ n z
gibbeted	_ I b I t I d
Ethiopian	i T I 5 p j @ n
drew	d r u
withdraw	w I D d r $
butchers	b U J @ z
surmised	s 3 m 2 z d
inmates	I n m 1 t s
herewith	h 7 w I D
rinse	r I n s
suiting	s u t I N
triumphed	t r 2 @ m f t
violent	v 2 @ l @ n t
distorted	d I s t $ t I d
encounter	I n k 6 n t @ R
thrill	T r I l
stateroom	s t 1 t r U m
awake	@ w 1 k
kilohertz	k i l 5 h 3 t s
discount	d I s k 6 n t
scheme	s k i m
heave	h i v
cascaded	k { s k 1 d I d
prepacks	p r i p { k s
pule	p j u l
tamps	t { m p s
spurred	s p 3 d
stagnated	s t { g n 1 t I d
darken	d # k @ n
permeable	p 3 m j @ b P
avouching	@ v 6 J I N
proceeded	p r @ s i d I d
clone	k l 5 n
perm	p 3 m
hurls	h 3 l z
freewill	f r i w I l
vivisect	v I v I s E k t
funnelled	f V n P d
rhapsody	r { p s @ d I
dripped	d r I p t
stalemate	s t 1 l m 1 t
fence	f E n s
protests	p r 5 t E s t s
away	@ w 1
token	t 5 k @ n
euclidean	j u k l I d 7 n
pantheism	p { n T i I z @ m
puniest	p j u n I I s t
hauteur	5 t 3 R
aped	1 p t
latitudes	l { t I t j u d z
buttoned	b V t H d
undone	V n d V n
iodizes	2 5 d 2 z I z
winced	w I n s t
heckled	h E k P d
ground	g r 6 n d
crow	k r 5
inches	I n J I z
feathered	f E D @ d
meseems	m I s i m z
bargee	b # _ i
betokened	b I t 5 k @ n d
replied	r I p l 2 d
suspect	s V s p E k t
clown	k l 6 n
bellowing	b E l 5 I N
foreboded	f $ b 5 d I d
buffet	b U f 1
filtrate	f I l t r 1 t
hellos	h @ l 5 z
dirty	d 3 t I
chipboard	J I p b $ d
emirs	E m 7 z
breathe	b r i D
soften	s Q f H
shag	S { g
locksmith	l Q k s m I T
womanized	w U m @ n 2 z d
widgeons	w I _ @ n z
nicknamed	n I k n 1 m d
litigates	l I t I g 1 t s
jovially	_ 5 v j @ l I
lavishly	l { v I S l I
sporrans	s p Q r @ n z
sniping	s n 2 p I N
taxation	t { k s 1 S H
sicken	s I k @ n
artifice	# t I f I s
tarrier	t # r 7 R
credulity	k r I d j u l @ t I
deputize	d E p j U t 2 z
hibernate	h 2 b @ n 1 t
talk	t $ k
mouthed	m 6 D d
monthly	m V n T l I
heights	h 2 t s
scupper	s k V p @ R
viscounts	v 2 k 6 n t s
bridled	b r 2 d P d
enliven	I n l 2 v H
weeds	w i d z
redirects	r i d I r E k t s
jump	_ V m p
beggar	b E g @ R
focus	f 5 k @ s
deodars	d I 5 d # z
Yugoslav	j u g 5 s l # v
moulder	m 5 l d @ R
nubs	n V b z
screw	s k r u
jailer	_ 1 l @ R
pattens	p { t H z
sixths	s I k s T s
smile	s m 2 l
clingy	k l I N I
mould	m 5 l d
trappings	t r { p I N z
tousle	t 6 z P
mumble	m V m b P
insist	I n s I s t
calyces	k 1 l I k s I z
zippy	z I p I
dwelling	d w E l I N
flipper	f l I p @ R
warped	w $ p t
neared	n 7 d
southerly	s V D @ l I
hunches	h V n J I z
uvulars	j u v j U l @ z
yellowest	j E l 5 I s t
feudal	f j u d P
deduct	d I d V k t
comment	k Q m E n t
hardened	h # d H d
snipped	s n I p t
deforest	d i f Q r I s t
seventeen	s E v H t i n
sandals	s { n d P z
scruple	s k r u p P
shelduck	S E l d V k
meantime	m i n t 2 m
entreated	I n t r i t I d
doubter	d 6 t @ R
jiggled	_ I g P d
rerun	r i r V n
effluxes	E f l V k s I z
cadge	k { _
popinjay	p Q p I n _ 1
absolute	{ b s @ l u t
parvenus	p # v @ n j u z
cagier	k 1 _ 7 R
shirk	S 3 k
scorebook	s k $ b U k
smoothed	s m u D d
catch	k { J
monolith	m Q n 5 l I T
keen	k i n
crossbred	k r Q s b r E d
noblemen	n 5 b P m @ n
tinplate	t I n p l 1 t
imbeciles	I m b I s i l z
shooed	S u d
scapula	s k { p j U l @
wrestler	r E s l @ R
cudgelled	k V _ @ l d
telexed	t E l E k s t
groaned	g r 5 n d
purchaser	p 3 J @ s @ R
rapacity	r @ p { s @ t I
pituitary	p I t j U I t @ r I
loosest	l u s I s t
tomahawk	t Q m @ h $ k
Elysian	I l I z 7 n
neither	n 2 D @ R
froth	f r Q T
barbarize	b # b @ r 2 z
skip	s k I p
wrecks	r E k s
crucifix	k r u s I f I k s
fervently	f 3 v @ n t l I
pinned	p I n d
wackiness	w { k I n I s
muted	m j u t I d
wheedling	w i d P I N
meant	m E n t
astride	@ s t r 2 d
brazing	b r 1 z I N
canton	k { n t Q n
ingrain	I n g r 1 n
recharge	r i J # _
keeper	k i p @ R
reunions	r i j u n j @ n z
murmured	m 3 m @ d
oxen	Q k s @ n
squired	s k w 2 @ d
ethereal	I T 7 r 7 l
monkey	m V N k I
passkeys	p # s k i z
arises	@ r 2 z I z
likely	l 2 k l I
chub	J V b
fomenting	f 5 m E n t I N
purr	p 3 R
quagga	k w { g @
ached	1 k t
jetted	_ E t I d
recited	r I s 2 t I d
cawed	k $ d
withers	w I D @ z
laments	l @ m E n t s
embattled	I m b { t P d
stated	s t 1 t I d
patterned	p { t @ n d
pillaged	p I l I _ d
gelling	_ E l I N
jollified	_ Q l I f 2 d
discard	d I s k # d
debagged	d i b { g d
smirking	s m 3 k I N
dated	d 1 t I d
abrogated	{ b r 5 g 1 t I d
lounged	l 6 n _ d
charnel	J # n P
cerebrate	s E r I b r 1 t
attested	@ t E s t I d
droop	d r u p
skylarked	s k 2 l # k t
barbarous	b # b @ r @ s
snag	s n { g
crappiest	k r { p I I s t
involve	I n v Q l v
bushy	b U S I
disclosed	d I s k l 5 z d
kappa	k { p @
saplings	s { p l I N z
diversely	d 2 v 3 s l I
misspent	m I s s p E n t
tormentor	t $ m E n t @ R
leather	l E D @ R
klaxons	k l { k s H z
pantheist	p { n T i I s t
astounded	@ s t 6 n d I d
traffic	t r { f I k
manometer	m @ n Q m I t @ R
chafed	J 1 f t
laundered	l $ n d @ d
mishear	m I s h 7 R
worthier	w 3 D 7 R
incessant	I n s E s H t
shinned	S I n d
rethink	r i T I N k
tootsies	t U t s I z
oxidize	Q k s I d 2 z
ankles	{ N k P z
nattiest	n { t I I s t
gondola	g Q n d @ l @
skimmed	s k I m d
sledges	s l E _ I z
blazoned	b l 1 z H d
reprisals	r I p r 2 z P z
rentable	r E n t @ b P
padlocks	p { d l Q k s
release	r I l i s
initials	I n I S P z
spurn	s p 3 n
tacked	t { k t
fattened	f { t H d
awfulness	$ f U l n I s
withdrew	w I D d r u
bimonthly	b 2 m V n T l I
amass	@ m { s
obsess	@ b s E s
nudge	n V _
Dutchman	d V J m @ n
tabooed	t @ b u d
noosed	n u s t
mused	m j u z d
freshness	f r E S n I s
predigest	p r i d 2 _ E s t
live	l I v
soldiered	s 5 l _ @ d
tussocks	t V s @ k s
evicted	I v I k t I d
crawling	k r $ l I N
highbrows	h 2 b r 6 z
biers	b 7 z
smoothest	s m u D I s t
thumbnail	T V m n 1 l
wolf	w U l f
recanted	r I k { n t I d
gods	g Q d z
miaow	m i 6
blur	b l 3 R
maple	m 1 p P
relocates	r i l 5 k 1 t s
creoles	k r i 5 l z
buttery	b V t @ r I
wanked	w { N k t
checked	J E k t
acquittal	@ k w I t P
yanking	j { N k I N
backchat	b { k J { t
dally	d { l I
agenda	@ _ E n d @
mulch	m V l J
Boers	b $ z
bandier	b { n d 7 R
they_QUOTE_d	D 1 d
gardened	g # d H d
Mauritian	m @ r I S H
thwarted	T w $ t I d
fluctuate	f l V k J U 1 t
scowl	s k 6 l
sneer	s n 7 R
fathom	f { D @ m
unleashed	V n l i S t
Sabbaths	s { b @ T s
cushioned	k U S H d
snow	s n 5
scrawl	s k r $ l
anyhow	E n I h 6
sneerer	s n 7 r @ R
withheld	w I D h E l d
thieved	T i v d
pulpit	p U l p I t
mafficked	m { f I k t
embezzles	I m b E z P z
rainy	r 1 n I
guzzle	g V z P
cobble	k Q b P
poached	p 5 J t
stumbled	s t V m b P d
sluiced	s l u s t
tribune	t r I b j u n
Tswanas	t s w # n @ z
cream	k r i m
miserable	m I z @ r @ b P
sluices	s l u s I z
metros	m E t r 5 z
offside	Q f s 2 d
socked	s Q k t
effigies	E f I _ I z
daubing	d $ b I N
how_QUOTE_s	h 6 z
requiem	r E k w 7 m
bother	b Q D @ R
pythons	p 2 T H z
thrashes	T r { S I z
youthful	j u T f U l
fetch	f E J
instep	I n s t E p
beadiest	b i d I I s t
contused	k @ n t j u z d
direct	d I r E k t
rumble	r V m b P
resin	r E z I n
hector	h E k t @ R
peacetime	p i s t 2 m
canker	k { N k @ R
totally	t 5 t P I
asked	# s k t
creep	k r i p
scabbards	s k { b @ d z
misruled	m I s r u l d
blabbed	b l { b d
overrate	5 v @ r 1 t
vitreous	v I t r 7 s
shrilling	S r I l I N
better	b E t @ R
firsts	f 3 s t s
reinsured	r i I n S $ d
pouched	p 6 J t
bother	b Q D @ R
harmattan	h # m { t H
foot	f U t
waft	w # f t
need	n i d
splotched	s p l Q J t
peekaboo	p i k @ b u
slashed	s l { S t
poked	p 5 k t
lackeys	l { k I z
pederasts	p E d @ r { s t s
startle	s t # t P
bathing	b 1 D I N
ossify	Q s I f 2
lance	l # n s
Greenwich	g r E n I _
intercoms	I n t @ k Q m z
examined	I g z { m I n d
iodized	2 5 d 2 z d
exempt	I g z E m p t
shaved	S 1 v d
kolas	k 5 l @ z
crayoning	k r 1 @ n I N
ibises	2 b I s I z
trust	t r V s t
girds	g 3 d z
spikenard	s p 2 k n # d
ships	S I p s
rescinded	r I s I n d I d
neither	n 2 D @ R
restored	r I s t $ d
outback	6 t b { k
magnesium	m { g n i z 7 m
orphans	$ f H z
Rwandans	r U { n d @ n z
tousled	t 6 z P d
salvia	s { l v 7
monotony	m @ n Q t H I
thrifty	T r I f t I
hook	h U k
brook	b r U k
spirited	s p I r I t I d
moon	m u n
roods	r u d z
sides	s 2 d z
roentgen	r Q n t j @ n
pitchfork	p I J f $ k
allowed	@ l 6 d
suppliant	s V p l 7 n t
they_QUOTE_d	D 1 d
govern	g V v H
fifteenth	f I f t i n T
orgasmic	$ g { z m I k
expertly	E k s p 3 t l I
expound	I k s p 6 n d
appear	@ p 7 R
tether	t E D @ R
unbidden	V n b I d H
throttled	T r Q t P d
footslog	f U t s l Q g
clip	k l I p
skim	s k I m
cambered	k { m b @ d
tame	t 1 m
pitifully	p I t I f U l I
dropkicks	d r Q p k I k s
rewire	r i w 2 @ R
mimed	m 2 m d
tied	t 2 d
