fondled	f Q n d P d
tragical	t r { _ I k P
tiger	t nc g @ R
ginger	_ I n _ @ R
smasher	s m { S @ R
estimate	E s t I m nb t
feuded	f j u d I d
damnedest	d { m d I s t
palomino	p { l @ m i n nf
vacant	v nb k @ n t
clap	k l { p
gathering	g { D @ r I N
garrison	g { r I s H
submitted	s @ b m I t I d
disdained	d I s d nb n d
tannin	t { n I n
applique	{ p l i k nb
bevel	b E v P
swine	s w nc n
pitied	p I t I d
clematis	k l E m @ t I s
dated	d nb t I d
burrs	b nd z
kopjes	k Q p I z
Bolivia	b @ l I v nh
amalgams	@ m { l g @ m z
brooks	b r U k s
ensiling	E n s nc l I N
jotting	_ Q t I N
softlands	s Q f t l { n d z
sprinters	s p r I n t @ z
sinewy	s I n j u I
quickened	k w I k @ n d
American	@ m E r I k @ n
Tauruses	t $ r @ s I z
roughcast	r V f k # s t
browned	b r ng n d
cohered	k nf h nh d
mixtures	m I k s J @ z
orthodoxy	$ T @ d Q k s I
darkened	d # k @ n d
whirled	w nd l d
doubted	d ng t I d
footbaths	f U t b # D z
heckle	h E k P
pardon	p # d H
choose	J u z
shaddocks	S { d @ k s
zeniths	z E n I T s
gazumping	g @ z V m p I N
crowbar	k r nf b # R
shit	S I t
lofts	l Q f t s
oncoming	Q n k V m I N
worsen	w nd s H
lever	l i v @ R
coat	k nf t
visaed	v i z @ d
masses	m { s I z
merge	m nd _
hexagrams	h E k s @ g r { m z
roasting	r $ s t I N
outstay	ng t s t nb
Gambian	g { m b nh n
wither	w I D @ R
congenial	k @ n _ i n j @ l
latch	l { J
ninetieth	n nc n t nh T
push	p U S
aerates	nb @ r nb t s
crimsoned	k r I m z H d
jujube	_ u _ u b
framework	f r nb m w nd k
hemming	h E m I N
jolliest	_ Q l I I s t
enshrined	I n S r nc n d
wasters	w nb s t @ z
slaughter	s l $ t @ R
pound	p ng n d
burthen	b nd D H
insinuate	I n s I n j U nb t
screeched	s k r i J t
thinks	T I N k s
lover	l V v @ R
sparkle	s p # k P
modify	m Q d I f nc
poverty	p Q v @ t I
harmonica	h # m Q n I k @
abortive	@ b $ t I v
quoted	k w nf t I d
flouted	f l ng t I d
friskier	f r I s k nh R
soothes	s u D z
numerated	n j u m @ r nb t I d
etching	E J I N
thirst	T nd s t
hurrahed	h U r # d
thrusting	T r V s t I N
vines	v nc n z
moped	m nf p t
grassed	g r # s t
jeers	_ nh z
mortgaged	m $ g I _ d
frowst	f r ng s t
smothered	s m V D @ d
omissions	@ m I S H z
yellow	j E l nf
workbench	w nd k b E n J
viable	v nc @ b P
emulous	E m j U l @ s
hoodoo	h u d u
preacher	p r i J @ R
rustles	r V s P z
reasoned	r i z H d
salt	s $ l t
crowns	k r ng n z
here_QUOTE_re	h nh r @ R
teethe	t i D
crocheted	k r nf S nb d
anther	{ n T @ R
shushes	S U S I z
chuckle	J V k P
outwore	ng t w $
galleons	g { l nh n z
brother	b r V D @ R
deception	d I s E p S H
piranha	p I r # n j @
thankful	T { N k f U l
cope	k nf p
mediated	m i d I nb t I d
curried	k V r I d
consignor	k @ n s nc n @ R
pant	p { n t
utilize	j u t @ l nc z
inbreed	I n b r i d
amorously	{ m @ r @ s l I
licks	l I k s
cannoning	k { n @ n I N
squids	s k w I d z
cottagers	k Q t I _ @ z
adeptly	{ d E p t
robe	r nf b
tunefully	t j u n f U l I
concerted	k @ n s nd t I d
disrepute	d I s r I p j u t
coalholes	k nf l h nf l z
seining	s nb n I N
calibre	k { l I b @ R
refresher	r I f r E S @ R
shelled	S E l d
pansy	p { n z I
yawed	j $ d
endows	I n d ng z
hereto	h nh t u
they_QUOTE_ll	D nb @ l
mention	m E n S H
crouched	k r ng J t
fiddle	f I d P
authentic	$ T E n t I k
perfume	p nd f j u m
sheered	S nh d
mouthed	m ng D d
deception	d I s E p S H
chaster	J nb s t @ R
addle	{ d P
thunder	T V n d @ R
stood	s t U d
Spartans	s p # t @ n z
sauce	s $ s
spied	s p nc d
curled	k nd l d
bearded	b nh d I d
clothing	k l nf D I N
gilding	g I l d I N
headships	h E d S I p s
listen	l I s H
arched	# J t
middled	m I d P d
enthral	I n T r $ l
butcher	b U J @ R
overplay	nf v @ p l nb
spyglass	s p nc g l # s
defer	d I f nd R
bouncy	b ng n s I
material	m @ t nh r nh l
fathomed	f { D @ m d
hemming	h E m I N
monotony	m @ n Q t H I
freeway	f r i w nb
dabbled	d { b P d
seventh	s E v H T
handbook	h { n d b U k
jumped	_ V m p t
asphalted	{ s f { l t I d
wait	w nb t
miscues	m I s k j u z
increase	I n k r i s
outset	ng t s E t
Quaker	k w nb k @ R
crooks	k r U k s
puckers	p V k @ z
vitalized	v nc t @ l nc z d
shoehorn	S u h $ n
version	v nd S H
either	nc D @ R
aggregate	{ g r I g nb t
cheaper	J i p @ R
levelling	l E v P I N
nothing	n V T I N
jargon	_ # g @ n
buggy	b V g I
wince	w I n s
warms	w $ m z
firm	f nd m
clout	k l ng t
earshot	nh S Q t
that	D { t
stretch	s t r E J
notable	n nf t @ b P
throats	T r nf t s
amputee	{ m p j U t i
messages	m E s I _ I z
scrawls	s k r $ l z
garnish	g # n I S
worst	w nd s t
growled	g r ng l d
spears	s p nh z
others	V D @ z
leasehold	l i s h nf l d
shorten	S $ t H
smirch	s m nd J
freckled	f r E k P d
pogrom	p Q g r @ m
threaded	T r E d I d
copulate	k Q p j U l nb t
gibber	_ I b @ R
avatars	{ v @ t # z
righted	r nc t I d
account	@ k ng n t
nuttier	n V t nh R
smoother	s m u D @ R
hushed	h V S t
burthens	b nd D H z
Christian	k r I s J @ n
causal	k $ z P
polymaths	p Q l I m { T s
augury	$ g j U r I
region	r i _ @ n
carp	k # p
cowhide	k ng h nc d
cheeriest	J nh r I I s t
siphons	s nc f H z
cradled	k r nb d P d
couth	k u T
teguments	t E g j U m @ n t s
Levant	l I v { n t
badgers	b { _ @ z
starched	s t # J t
incurred	I n k nd d
overturn	nf v @ t nd n
madhouse	m { d h ng s
crabbier	k r { b nh R
seethe	s i D
forgotten	f @ g Q t H
snaffled	s n { f P d
threes	T r i z
ruin	r U I n
warble	w $ b P
managed	m { n I _ d
shark	S # k
whitened	w nc t H d
abos	{ b nf z
louring	l ng @ r I N
theatres	T nh t @ z
clothing	k l nf D I N
harmonies	h # m @ n I z
execute	E k s I k j u t
munched	m V n J t
promise	p r Q m I s
footnoted	f U t n nf t I d
averring	@ v nd r I N
histology	h I s t Q l @ _ I
declined	d I k l nc n d
chinks	J I N k s
chocking	J Q k I N
sandstorm	s { n d s t $ m
outskirts	ng t s k nd t s
frillier	f r I l nh R
mother	m V D @ R
slovens	s l V v H z
reeks	r i k s
hewer	h j u @ R
waggle	w { g P
berth	b nd T
bullfinch	b U l f I n J
ejaculate	I _ { k j U l nb t
attract	@ t r { k t
lunchtime	l V n J t nc m
servitors	s nd v I t @ z
component	k @ m p nf n @ n t
fumbles	f V m b P z
wedged	w E _ d
proffer	p r Q f @ R
metal	m E t P
disallow	d I s @ l ng
uprose	V p r nf z
rolls	r nf l z
underpins	V n d @ p I n z
deplaned	d i p l nb n d
ruffed	r V f t
heard	h nd d
dean	d i n
stumbled	s t V m b P d
enhanced	I n h # n s t
outweigh	ng t w nb
slate	s l nb t
spoons	s p u n z
frustrate	f r V s t r nb t
erase	I r nb z
roadbeds	r nf d b E d z
cyclamens	s I k l @ m @ n z
fielding	f i l d I N
grimaced	g r I m nb s t
shored	S $ d
aqueous	nb k w nh s
dither	d I D @ R
leaven	l E v H
tenth	t E n T
relined	r i l nc n d
disbursed	d I s b nd s t
fawns	f $ n z
jarred	_ # d
realized	r nh l nc z d
fathoms	f { D @ m z
ravened	r { v H d
scapula	s k { p j U l @
anthem	{ n T @ m
nudist	n j u d I s t
abate	@ b nb t
patched	p { J t
Romany	r Q m @ n I
exerted	I g z nd t I d
stirred	s t nd d
slanting	s l # n t I N
sightseer	s nc t s i @ R
teethe	t i D
clip	k l I p
uprose	V p r nf z
encores	Q N k $ z
kotow	k nf t ng
realizes	r nh l nc z I z
curtain	k nd t H
Methodist	m E T @ d I s t
eschew	I s J u
forefoot	f $ f U t
raged	r nb _ d
upstart	V p s t # t
township	t ng n S I p
weary	w nh r I
withheld	w I D h E l d
education	E _ U k nb S H
unit	j u n I t
straddle	s t r { d P
moths	m Q T s
prevented	p r I v E n t I d
knock	n Q k
lamed	l nb m d
hail	h nb l
sentences	s E n t @ n s I z
punch	p V n J
cherish	J E r I S
oafs	nf f s
amended	@ m E n d I d
flirts	f l nd t s
when_QUOTE_ve	w E n @ v
roofs	r u f s
syllabize	s I l @ b nc z
floated	f l nf t I d
unbound	V n b ng n d
footslog	f U t s l Q g
foretop	f $ t Q p
partition	p # t I S H
weirdos	w nh d nf z
furthest	f nd D I s t
bugled	b j u g P d
sixth	s I k s T
cribbage	k r I b I _
vacating	v @ k nb t I N
maimed	m nb m d
suffice	s @ f nc s
cambers	k { m b @ z
fervour	f nd v @ R
clambake	k l { m b nb k
trowels	t r ng @ l z
troubles	t r V b P z
doctorate	d Q k t @ r @ t
subway	s V b w nb
squallers	s k w $ l @ z
grants	g r # n t s
cheering	J nh r I N
slithery	s l I D @ r I
heat	h i t
freshens	f r E S H z
apiaries	nb p j @ r I z
threaded	T r E d I d
crook	k r U k
perjure	p nd _ @ R
drummer	d r V m @ R
rinses	r I n s I z
crook	k r U k
fathomed	f { D @ m d
entitling	I n t nc t P I N
thanks	T { N k s
encircled	I n s nd k P d
alveolars	{ l v nh l @ z
quoted	k w nf t I d
haricot	h { r I k nf
shoplifts	S Q p l I f t s
botanized	b Q t @ n nc z d
dominated	d Q m I n nb t I d
debarks	d I b # k s
requests	r I k w E s t s
paused	p $ z d
doused	d ng s t
hortation	h $ t nb S H
yammer	j { m @ R
unite	j u n nc t
derange	d I r nb n _
barmy	b # m I
council	k ng n s P
nadirs	n nb d nh z
blethered	b l E D @ d
reason	r i z H
mothproof	m Q T p r u f
bookie	b U k I
gypped	_ I p t
feigned	f nb n d
ribbed	r I b d
abate	@ b nb t
envy	E n v I
accused	@ k j u z d
instruct	I n s t r V k t
tangiest	t { N I I s t
buffer	b V f @ R
unlearns	V n l nd n z
belay	b I l nb
wobble	w Q b P
carry	k { r I
upgrade	V p g r nb d
fused	f j u z d
nobble	n Q b P
filched	f I l J t
relapse	r I l { p s
bated	b nb t I d
denier	d I n nc @ R
sermonize	s nd m @ n nc z
shelduck	S E l d V k
caraway	k { r @ w nb
puffed	p V f t
cringed	k r I n _ d
vestigial	v E s t I _ nh l
economize	I k Q n @ m nc z
forever	f @ r E v @ R
clew	k l u
deluded	d I l u d I d
blubber	b l V b @ R
braving	b r nb v I N
rings	r I N z
masonic	m @ s Q n I k
Dutch	d V J
wrapper	r { p @ R
maim	m nb m
cleanup	k l i n V p
gardener	g # d n @ R
fielding	f i l d I N
duels	d j u @ l z
evicted	I v I k t I d
cholera	k Q l @ r @
gasify	g { s I f nc
roneoing	r nf n I nf I N
tough	t V f
encrusted	I n k r V s t I d
arrange	@ r nb n _
born	b $ n
outbraves	ng t b r nb v z
feathered	f E D @ d
eggheads	E g h E d z
position	p @ z I S H
throws	T r nf z
kukri	k U k r I
sellers	s E l @ z
prejudged	p r i _ V _ d
corners	k $ n @ z
carburet	k # b j U r E t
outbrave	ng t b r nb v
reared	r nh d
others	V D @ z
abhorred	@ b h $ d
dictation	d I k t nb S H
overthrow	nf v @ T r nf
hardened	h # d H d
mounts	m ng n t s
clearing	k l nh r I N
wreathe	r i D
uncharted	V n J # t I d
thatched	T { J t
dreadful	d r E d f U l
beam	b i m
downpour	d ng n p $ R
Syria	s I r nh
withholds	w I D h nf l d z
glistens	g l I s H z
tackles	t { k P z
overthrow	nf v @ T r nf
pushily	p U S I l I
fixating	f I k s nb t I N
tank	t { N k
deject	d I _ E k t
salaam	s @ l # m
tiller	t I l @ R
donning	d Q n I N
craved	k r nb v d
wigged	w I g d
hamstring	h { m s t r I N
tools	t u l z
rave	r nb v
maunder	m $ n d @ R
drowsed	d r ng z d
wristier	r I s t nh R
blethers	b l E D @ z
pardoned	p # d H d
Fuchs	f j u k s
beach	b i J
capital	k { p I t P
throbs	T r Q b z
plentiful	p l E n t I f U l
wheedle	w i d P
labelled	l nb b P d
museum	m j u z nh m
gracing	g r nb s I N
banqueted	b { N k w I t I d
churn	J nd n
refuse	r E f j u s
degraded	d I g r nb d I d
persuade	p @ s w nb d
grab	g r { b
staple	s t nb p P
duplicate	d j u p l I k @ t
dubbing	d V b I N
crocking	k r Q k I N
unbending	V n b E n d I N
cantered	k { n t @ d
slaved	s l nb v d
walled	w $ l d
outstay	ng t s t nb
clothe	k l nf D
exhuming	E k s h j u m I N
ravening	r { v H I N
ethics	E T I k s
cumulus	k j u m j U l @ s
condense	k @ n d E n s
bless	b l E s
mastiffs	m { s t I f s
raises	r nb z I z
lactate	l { k t nb t
hush	h V S
Chilean	J I l nh n
sunburned	s V n b nd n d
seller	s E l @ R
baking	b nb k I N
crane	k r nb n
regrouped	r i g r u p t
nicotine	n I k @ t i n
bullring	b U l r I N
phalanx	f { l { N k s
goatee	g nf t i
joked	_ nf k t
stroking	s t r nf k I N
gridiron	g r I d nc @ n
leotards	l i nf t # d z
guffaw	g V f $
denounced	d I n ng n s t
that_QUOTE_d	D { t @ d
openwork	nf p H w nd k
Thespian	T E s p nh n
Blimpish	b l I m p I S
ombudsman	Q m b U d z m @ n
jived	_ nc v d
dowels	d ng @ l z
deedpoll	d i d p nf l
hated	h nb t I d
cheque	J E k
slackened	s l { k @ n d
laughed	l # f t
knotted	n Q t I d
drop	d r Q p
went	w E n t
Guards	g # d z
squealers	s k w i l @ z
belay	b I l nb
only	nf n l I
surfers	s nd f @ z
apostates	@ p Q s t nb t s
rusk	r V s k
fastens	f # s H z
dower	d ng @ R
implement	I m p l I m E n t
divide	d I v nc d
become	b I k V m
lachrymal	l { k r I m P
ambling	{ m b l I N
thrift	T r I f t
pioneered	p nc @ n nh d
snore	s n $ R
blathered	b l { D @ d
heptagon	h E p t @ g @ n
built	b I l t
macaroon	m { k @ r u n
moaning	m nf n I N
creakiest	k r i k I I s t
free	f r i
antidote	{ n t I d nf t
muddled	m V d P d
dipstick	d I p s t I k
lack	l { k
peacock	p i k Q k
prejudice	p r E _ U d I s
ghettos	g E t nf z
quilted	k w I l t I d
boodles	b u d P z
smirched	s m nd J t
toboggan	t @ b Q g @ n
timer	t nc m @ R
bitters	b I t @ z
subserved	s @ b s nd v d
relenting	r I l E n t I N
sozzled	s Q z @ l d
support	s @ p $ t
further	f nd D @ R
maidenly	m nb d H l I
thwarted	T w $ t I d
outshines	ng t S nc n z
here	h nh R
mouth	m ng D
fattened	f { t H d
quenched	k w E n J t
rethink	r i T I N k
steward	s t j U @ d
regiment	r E _ I m E n t
inflated	I n f l nb t I d
flustered	f l V s t @ d
cant	k { n t
untangled	V n t { N g P d
equalized	i k w @ l nc z d
barrel	b { r @ l
joggled	_ Q g P d
happening	h { p H I N
fallow	f { l nf
recurred	r I k nd d
skulked	s k V l k t
bobbed	b Q b d
article	# t I k P
worded	w nd d I d
hacks	h { k s
staple	s t nb p P
wreathed	r i D d
riptides	r I p t nc d z
borrows	b Q r nf z
dive	d nc v
plummet	p l V m I t
demented	d I m E n t I d
stacked	s t { k t
rustled	r V s P d
hews	h j u z
fixtures	f I k s J @ z
unbound	V n b ng n d
carter	k # t @ R
dissuaded	d I s w nb d I d
beat	b i t
depleted	d I p l i t I d
glowed	g l nf d
heralds	h E r @ l d z
glint	g l I n t
sibilants	s I b I l @ n t s
whiz	w I z
finesse	f I n E s
congested	k @ n _ E s t I d
jiggered	_ I g @ d
fatigues	f @ t i g z
exculpate	E k s k V l p nb t
pawl	p $ l
deviance	d i v nh n s
position	p @ z I S H
amethysts	{ m I T I s t s
sputnik	s p U t n I k
battue	b { t u
routed	r ng t I d
serenely	s I r i n l I
fortune	f $ J u n
appears	@ p nh z
blathered	b l { D @ d
motion	m nf S H
orthodox	$ T @ d Q k s
cook	k U k
centavos	s E n t # v nf z
reredoses	r nh d Q s I z
teethed	t i D d
enchain	I n J nb n
cash	k { S
thumped	T V m p t
babyhood	b nb b I h U d
menders	m E n d @ z
major	m nb _ @ R
sprint	s p r I n t
tennis	t E n I s
halo	h nb l nf
sedan	s I d { n
least	l i s t
bowing	b ng I N
crimp	k r I m p
sewed	s nf d
yield	j i l d
power	p ng @ R
mandarin	m { n d @ r I n
plimsoll	p l I m s @ l
enouncing	i n ng n s I N
grazier	g r nb z j @ R
plotter	p l Q t @ R
plashing	p l { S I N
boxed	b Q k s t
reworded	r i w nd d I d
scabbier	s k { b nh R
spadefuls	s p nb d f U l z
chickens	J I k I n z
chandlers	J # n d l @ z
tanning	t { n I N
cubits	k j u b I t s
desiring	d I z nc @ r I N
siphon	s nc f H
macerated	m { s @ r nb t I d
bludgeon	b l V _ @ n
pantos	p { n t nf z
baseboard	b nb s b $ d
without	w I D ng t
thwacks	T w { k s
humiliate	h j u m I l I nb t
deplete	d I p l i t
motions	m nf S H z
bleeped	b l i p t
engrave	I n g r nb v
sole	s nf l
faraway	f # r @ w nb
impacted	I m p { k t I d
grinders	g r nc n d @ z
outsold	ng t s nf l d
compel	k @ m p E l
curse	k nd s
gabble	g { b P
anthrax	{ n T r { k s
efflux	E f l V k s
gush	g V S
muted	m j u t I d
silenced	s nc l @ n s t
repeal	r I p i l
burthens	b nd D H z
hinders	h I n d @ z
rococo	r nf k nf k nf
marvels	m # v P z
revel	r E v P
embrace	I m b r nb s
milker	m I l k @ R
upgraded	V p g r nb d I d
adored	@ d $ d
uneasier	V n i z nh R
regulated	r E g j U l nb t I d
ache	nb k
sundered	s V n d @ d
singed	s I n _ d
converged	k @ n v nd _ d
journey	_ nd n I
blasted	b l # s t I d
fiasco	f I { s k nf
sublet	s V b l E t
sagged	s { g d
vault	v $ l t
earshot	nh S Q t
betroth	b I t r nf D
poached	p nf J t
toothiest	t u T I I s t
stewarded	s t j U @ d I d
ocarinas	Q k @ r i n @ z
mangers	m nb n _ @ z
struck	s t r V k
published	p V b l I S t
clobber	k l Q b @ R
assayed	@ s nb d
shag	S { g
havering	h nb v @ r I N
Wilton	w I l t @ n
clunked	k l V N k t
rivet	r I v I t
moreover	m $ r nf v @ R
sneer	s n nh R
sunbathed	s V n b nb D d
Haitian	h nb S H
chains	J nb n z
thawed	T $ d
wouldn_QUOTE_t	w U d H t
argue	# g j u
bearded	b nh d I d
bathed	b nb D d
hunched	h V n J t
death	d E T
deputized	d E p j U t nc z d
mussed	m V s t
milliners	m I l I n @ z
murder	m nd d @ R
plushiest	p l V S I I s t
curtail	k nd t nb l
changed	J nb n _ d
retired	r I t nc @ d
mart	m # t
irritate	I r I t nb t
warhorse	w $ h $ s
trouser	t r ng z @ R
imperious	I m p nh r nh s
heathen	h i D H
tenthly	t E n T l I
shushed	S U S t
cardamom	k # d @ m @ m
rouses	r ng z I z
smoothly	s m u D l I
prisoner	p r I z H @ R
chirruped	J I r @ p t
grumbled	g r V m b P d
throttle	T r Q t P
simulated	s I m j U l nb t I d
tilled	t I l d
entombed	I n t u m d
faulted	f $ l t I d
starved	s t # v d
outranged	ng t r nb n _ d
clumsier	k l V m z nh R
blethers	b l E D @ z
legations	l I g nb S H z
lychees	l nc J i z
gunsmiths	g V n s m I T s
basketful	b # s k I t f U l
fireball	f nc @ b $ l
compound	k @ m p ng n d
weightier	w nb t nh R
weathered	w E D @ d
freshens	f r E S H z
mulches	m V l J I z
jungle	_ V N g P
plinths	p l I n T s
hoodwinks	h U d w I N k s
ketches	k E J I z
either	nc D @ R
aerate	nb @ r nb t
Cypriots	s I p r nh t s
Kashmiris	k { S m nh r I z
irascibly	I r { s @ b l I
rashness	r { S n I s
fresher	f r E S @ R
buzzards	b V z @ d z
Taurus	t $ r @ s
grandaunt	g r { n d # n t
browbeat	b r ng b i t
seasoned	s i z H d
stippled	s t I p P d
thumbed	T V m d
insular	I n s j U l @ R
journeyed	_ nd n I d
caper	k nb p @ R
statuette	s t { t j U E t
converts	k @ n v nd t s
spoof	s p u f
notes	n nf t s
arrange	@ r nb n _
games	g nb m z
portrays	p $ t r nb z
arcades	# k nb d z
tower	t ng @ R
smothered	s m V D @ d
soften	s Q f H
miniature	m I n @ J @ R
jiggled	_ I g P d
berth	b nd T
tattled	t { t P d
washed	w Q S t
despots	d E s p Q t s
pulsate	p V l s nb t
shakiness	S nb k I n I s
cock	k Q k
wilted	w I l t I d
sprouted	s p r ng t I d
obsidian	Q b s I d nh n
garb	g # b
riling	r nc l I N
scuffmark	s k V f m # k
perchance	p @ J # n s
tack	t { k
outflank	ng t f l { N k
undulates	V n d j U l nb t s
mask	m # s k
befriend	b I f r E n d
jitney	_ I t n I
flagstaff	f l { g s t # f
shores	S $ z
gather	g { D @ R
coherent	k nf h nh r @ n t
legation	l I g nb S H
amethyst	{ m I T I s t
lobbyists	l Q b I I s t s
ectoplasm	E k t nf p l { z @ m
haulier	h $ l j @ R
pyorrhoea	p nc @ r nh
breathing	b r i D I N
evened	i v H d
puncture	p V N k J @ R
capitals	k { p I t P z
healthy	h E l T I
maturate	m { t j U r nb t
queer	k w nh R
strike	s t r nc k
pale	p nb l
grills	g r I l z
flowers	f l ng @ z
emperor	E m p @ r @ R
gong	g Q N
pings	p I N z
trumpets	t r V m p I t s
read	r E d
baronetcy	b { r @ n I t s I
behest	b I h E s t
inrushes	I n r V S I z
empyrean	E m p nc r i @ n
swatted	s w Q t I d
confused	k @ n f j u z d
Marxist	m # k s I s t
prong	p r Q N
snuffling	s n V f l I N
miscued	m I s k j u d
sneaking	s n i k I N
wafts	w # f t s
wall	w $ l
furnish	f nd n I S
feathers	f E D @ z
emulsion	I m V l S H
cheerless	J nh l I s
dangle	d { N g P
through	T r u
amputate	{ m p j U t nb t
syringed	s I r I n _ d
marmot	m # m @ t
botch	b Q J
coupled	k V p P d
jauntiest	_ $ n t I I s t
dirk	d nd k
counties	k ng n t I z
dithered	d I D @ d
reddened	r E d H d
thermal	T nd m P
doubtful	d ng t f U l
ravioli	r { v I nf l I
outmarch	ng t m # J
moved	m u v d
tweak	t w i k
harvested	h # v I s t I d
future	f j u J @ R
cousin	k V z H
rooked	r U k t
lioness	l nc @ n E s
trepan	t r I p { n
told	t nf l d
accompany	@ k V m p @ n I
dealt	d E l t
refracted	r I f r { k t I d
showery	S ng @ r I
photon	f nf t Q n
soaped	s nf p t
shampoos	S { m p u z
tittered	t I t @ d
widows	w I d nf z
bated	b nb t I d
throes	T r nf z
bastes	b nb s t s
roamed	r nf m d
cacao	k @ k # nf
anodes	{ n nf d z
rebuilds	r i b I l d z
plotted	p l Q t I d
fitted	f I t I d
rummage	r V m I _
averred	@ v nd d
tenant	t E n @ n t
frights	f r nc t s
sopped	s Q p t
noose	n u s
sandbox	s { n d b Q k s
cajolery	k @ _ nf l @ r I
underbid	V n d @ b I d
whimper	w I m p @ R
egotrips	i g nf t r I p s
burthened	b nd D H d
misted	m I s t I d
cromlech	k r Q m l E k
bewailed	b I w nb l d
pawed	p $ d
caressed	k @ r E s t
cage	k nb _
sideswipe	s nc d s w nc p
smelled	s m E l d
shear	S nh R
louvred	l u v @ d
assault	@ s $ l t
slither	s l I D @ R
hosanna	h nf z { n @
settle	s E t P
thriftily	T r I f t I l I
manumit	m { n j U m I t
service	s nd v I s
shower	S ng @ R
drudgery	d r V _ @ r I
impaled	I m p nb l d
baronets	b { r @ n I t s
continued	k @ n t I n j u d
sonny	s V n I
brochures	b r nf S @ z
clucked	k l V k t
quit	k w I t
subsidize	s V b s I d nc z
redirect	r i d I r E k t
bacteria	b { k t nh r nh
shafted	S # f t I d
slatier	s l nb t nh R
mystify	m I s t I f nc
whiffs	w I f s
dabs	d { b z
account	@ k ng n t
casts	k # s t s
cudgelled	k V _ @ l d
solders	s Q l d @ z
auburn	$ b @ n
whether	w E D @ R
hung	h V N
jettison	_ E t I s H
choosiest	J u z I I s t
strangle	s t r { N g P
billionth	b I l j @ n T
pushy	p U S I
resettled	r i s E t P d
damns	d { m z
mentioned	m E n S H d
umpteenth	V m p t i n T
equate	I k w nb t
fuddle	f V d P
cringe	k r I n _
rained	r nb n d
hummed	h V m d
claim	k l nb m
exceed	I k s i d
unloosed	V n l u s t
fibbed	f I b d
beetroot	b i t r u t
nought	n $ t
unscathed	V n s k nb D d
statues	s t { J u z
Buddhism	b U d I z @ m
lobs	l Q b z
calendars	k { l I n d @ z
belied	b I l nc d
encased	I n k nb s t
pleasing	p l i z I N
unzipping	V n z I p I N
frappe	f r { p nb
combat	k Q m b { t
patterned	p { t @ n d
hauliers	h $ l j @ z
teamwork	t i m w nd k
leather	l E D @ R
loosened	l u s H d
notch	n Q J
bethink	b I T I N k
sugarier	S U g @ r nh R
cuttingly	k V t I N l I
actuality	{ k J U { l @ t I
gurgled	g nd g P d
infract	I n f r { k t
confines	k @ n f nc n z
deflated	d I f l nb t I d
doubled	d V b P d
defer	d I f nd R
knead	n i d
deftest	d E f t I s t
lapels	l @ p E l z
lapses	l { p s I z
solder	s Q l d @ R
reunite	r i j u n nc t
rands	r { n d z
decontrol	d i k @ n t r nf l
floated	f l nf t I d
marching	m # J I N
gibbet	_ I b I t
frumps	f r V m p s
Frisbee	f r I z b I
grapnel	g r { p n P
compos	k Q m p nf z
flyweight	f l nc w nb t
Doric	d Q r I k
denied	d I n nc d
tote	t nf t
rewarding	r I w $ d I N
dowagers	d ng @ _ @ z
fathoms	f { D @ m z
humanizes	h j u m @ n nc z I z
partition	p # t I S H
froth	f r Q T
wonderful	w V n d @ f U l
shako	S { k nf
prawns	p r $ n z
outvied	ng t v nc d
loopier	l u p nh R
fathoms	f { D @ m z
withhold	w I D h nf l d
uneaten	V n i t H
leviathan	l I v nc @ T H
patent	p nb t @ n t
horseshit	h $ s S I t
journey	_ nd n I
cows	k ng z
idealizes	nc d nh l nc z I z
church	J nd J
bathed	b # T t
evacuates	I v { k j U nb t s
delayed	d I l nb d
basked	b # s k t
frieze	f r i z
engenders	I n _ E n d @ z
fancy	f { n s I
adduced	@ d j u s t
possessed	p @ z E s t
pierrot	p nh r nf
narrow	n { r nf
repotted	r i p Q t I d
shrill	S r I l
redo	r i d u
cleansed	k l E n z d
surfeits	s nd f I t s
bandsman	b { n d z m @ n
jaundiced	_ $ n d I s t
carousal	k @ r ng z P
gathering	g { D @ r I N
hurried	h V r I d
heartened	h # t H d
thin	T I n
evaluated	I v { l j U nb t I d
heartened	h # t H d
pinstripe	p I n s t r nc p
prettify	p r I t I f nc
impugned	I m p j u n d
flashed	f l { S t
diplomats	d I p l @ m { t s
label	l nb b P
blew	b l u
bellows	b E l nf z
snipes	s n nc p s
cudgelled	k V _ @ l d
account	@ k ng n t
jobbing	_ Q b I N
refill	r i f I l
abandon	@ b { n d @ n
sterns	s t nd n z
flipping	f l I p I N
garnered	g # n @ d
fine	f nc n
dither	d I D @ R
sailed	s nb l d
milking	m I l k I N
dulled	d V l d
unseated	V n s i t I d
thug	T V g
shampooed	S { m p u d
dolefully	d nf l f U l I
stored	s t $ d
spunkier	s p V N k nh R
crunchy	k r V n J I
staked	s t nb k t
papaws	p @ p $ z
amounts	@ m ng n t s
bloodier	b l V d nh R
bypaths	b nc p # D z
nations	n nb S H z
overarch	nf v @ r # J
piffling	p I f P I N
buckteeth	b V k t i T
populate	p Q p j U l nb t
calling	k $ l I N
murderer	m nd d @ r @ R
grouse	g r ng s
besmear	b I s m nh R
clothed	k l nf D d
hole	h nf l
ordinate	$ d H @ t
marchers	m # J @ z
libelled	l nc b P d
thrust	T r V s t
bivouac	b I v U { k
turbines	t nd b nc n z
bughouse	b V g h ng s
besmear	b I s m nh R
untruths	V n t r u D z
gardened	g # d H d
ratchet	r { J I t
wobble	w Q b P
thanks	T { N k s
pullback	p U l b { k
belt	b E l t
calked	k $ k t
inertia	I n nd S @
wound	w ng n d
weary	w nh r I
swathed	s w nb D d
hiccup	h I k V p
lessons	l E s H z
chives	J nc v z
deniable	d I n nc @ b P
Lutheran	l u T @ r @ n
withstood	w I D s t U d
selected	s I l E k t I d
alternate	$ l t @ n nb t
purging	p nd _ I N
pounced	p ng n s t
sixtieths	s I k s t nh T s
heave	h i v
leaven	l E v H
chirruped	J I r @ p t
ambles	{ m b P z
faithful	f nb T f U l
fatigues	f @ t i g z
slaked	s l nb k t
firebreak	f nc @ b r nb k
hope	h nf p
heretic	h E r @ t I k
thrum	T r V m
corruptly	k @ r V p t l I
compilers	k @ m p nc l @ z
locusts	l nf k @ s t s
decreed	d I k r i d
jollify	_ Q l I f nc
unbarring	V n b # r I N
outsider	ng t s nc d @ R
westward	w E s t w @ d
attempted	@ t E m p t I d
approved	@ p r u v d
shake	S nb k
crochet	k r nf S nb
langsyne	l { N s nc n
fate	f nb t
acorn	nb k $ n
research	r I s nd J
pithier	p I T nh R
smoother	s m u D @ R
harmattan	h # m { t H
yapped	j { p t
muzzle	m V z P
spoonfuls	s p u n f U l z
anilines	{ n I l i n z
impugned	I m p j u n d
tracery	t r nb s @ r I
foots	f U t s
sketched	s k E J t
jellied	_ E l I d
exuding	I g z j u d I N
boated	b nf t I d
pentagon	p E n t @ g @ n
spurts	s p nd t s
Gurkhas	g nd k @ z
shoe	S u
antedated	{ n t I d nb t I d
orientate	$ r I E n t nb t
pounces	p ng n s I z
furriers	f V r nh z
weather	w E D @ R
orations	$ r nb S H z
heckled	h E k P d
pounce	p ng n s
fear	f nh R
wreathe	r i D
raisin	r nb z H
quenched	k w E n J t
encircled	I n s nd k P d
regulated	r E g j U l nb t I d
egregious	I g r i _ @ s
wedded	w E d I d
centre	s E n t @ R
savages	s { v I _ I z
trollop	t r Q l @ p
mustard	m V s t @ d
professed	p r @ f E s t
amusing	@ m j u z I N
repeat	r I p i t
decide	d I s nc d
opening	nf p @ n I N
cremate	k r I m nb t
morale	m Q r # l
talks	t $ k s
spouted	s p ng t I d
sandier	s { n d nh R
mothers	m V D @ z
students	s t j u d H t s
charcoal	J # k nf l
puddle	p V d P
thanks	T { N k s
pulls	p U l z
reps	r E p s
rubbers	r V b @ z
short	S $ t
chirps	J nd p s
showdowns	S nf d ng n z
neared	n nh d
lathered	l # D @ d
hold	h nf l d
reckoner	r E k H @ R
crinkled	k r I N k P d
goldsmith	g nf l d s m I T
mistook	m I s t U k
evangels	I v { n _ E l z
rumbled	r V m b P d
tribals	t r nc b P z
smacked	s m { k t
gecko	g E k nf
aniseed	{ n I s i d
pooh	p h u
terrorism	t E r @ r I z @ m
preachify	p r i J I f nc
senna	s E n @
zloty	z l Q t I
stride	s t r nc d
yarn	j # n
linked	l I N k t
macs	m { k s
altered	$ l t @ d
purchased	p nd J @ s t
frowsted	f r ng s t I d
near	n nh R
scythe	s nc D
promotion	p r @ m nf S H
theocracy	T I Q k r @ s I
peculate	p E k j U l nb t
overtaxed	nf v @ t { k s t
adagio	@ d # _ I nf
gavotte	g @ v Q t
tailed	t nb l d
hear	h nh R
bestride	b I s t r nc d
briefed	b r i f t
inculpate	I n k V l p nb t
moors	m $ z
divergent	d nc v nd _ @ n t
miaouing	m i ng I N
smoothest	s m u D I s t
caution	k $ S H
methyl	m E T I l
modular	m Q d j U l @ R
purposed	p nd p @ s t
down	d ng n
earmarks	nh m # k s
weathers	w E D @ z
Holiness	h nf l I n I s
rejection	r I _ E k S H
patch	p { J
giggles	g I g P z
cloths	k l Q T s
cooking	k U k I N
bard	b # d
lopped	l Q p t
ripsaw	r I p s $
murderess	m nd d @ r I s
outhouses	ng t h ng z I z
domineer	d Q m I n nh R
mother	m V D @ R
govern	g V v H
charwomen	J # w I m I n
bicycles	b nc s I k P z
unearthed	V n nd T t
valvular	v { l v j U l @ R
restage	r i s t nb _
retreat	r I t r i t
armourers	# m @ r @ z
flitch	f l I J
bustled	b V s P d
living	l I v I N
etched	E J t
postulate	p Q s t j U l nb t
sunbathed	s V n b nb D d
staccato	s t @ k # t nf
fustiness	f V s t I n I s
oppugned	@ p j u n d
sprung	s p r V N
said	s E d
exacts	I g z { k t s
overhauls	nf v @ h $ l z
tear	t nh R
magicians	m @ _ I S H z
plethora	p l E T @ r @
grouse	g r ng s
fund	f V n d
expiry	I k s p nc @ r I
decorated	d E k @ r nb t I d
burred	b nd d
sieve	s I v
roar	r $ R
serial	s nh r nh l
sunbathed	s V n b nb D d
hotly	h Q t l I
straiten	s t r nb t H
gambol	g { m b P
lethal	l i T P
precook	p r i k U k
fidgeted	f I _ I t I d
queer	k w nh R
solidify	s @ l I d I f nc
thinning	T I n I N
retaliate	r I t { l I nb t
sellotape	s E l nf t nb p
Calvinist	k { l v I n I s t
threshes	T r E S I z
footslogs	f U t s l Q g z
pastings	p nb s t I N z
barbarity	b # b { r @ t I
inflame	I n f l nb m
respect	r I s p E k t
rail	r nb l
patent	p nb t @ n t
embanking	I m b { N k I N
muffled	m V f P d
swap	s w Q p
bite	b nc t
harrying	h { r I I N
hexed	h E k s t
back	b { k
jolt	_ nf l t
omelet	Q m l I t
misused	m I s j u z d
slopes	s l nf p s
unbend	V n b E n d
erroneous	I r nf n j @ s
locust	l nf k @ s t
outvoted	ng t v nf t I d
cafe	k { f nb
donate	d nf n nb t
predicate	p r E d I k nb t
foggy	f Q g I
acrid	{ k r I d
honked	h Q N k t
gibberish	_ I b @ r I S
classmate	k l # s m nb t
crucify	k r u s I f nc
mothproof	m Q T p r u f
bloaters	b l nf t @ z
apportion	@ p $ S H
furs	f nd z
logarithm	l Q g @ r I D @ m
hunched	h V n J t
frugally	f r u g @ l I
pitted	p I t I d
halitosis	h { l I t nf s I s
swell	s w E l
soused	s ng s t
fishpaste	f I S p nb s t
zucchini	z U k i n I
smiled	s m nc l d
Palladio	p @ l { d I nf
slab	s l { b
sheilas	S i l @ z
upbraid	V p b r nb d
burly	b nd l I
augment	$ g m E n t
leathers	l E D @ z
washbasin	w Q S b nb s H
lurched	l nd J t
instigate	I n s t I g nb t
pimply	p I m p l I
scar	s k # R
dottiest	d Q t I I s t
beeswaxed	b i z w { k s t
defrocks	d i f r Q k s
peasantry	p E z H t r I
tumble	t V m b P
tarry	t { r I
Sybaris	s I b @ r I s
adapted	@ d { p t I d
heartened	h # t H d
trier	t r nc @ R
bothered	b Q D @ d
impose	I m p nf z
staff	s t # f
clawed	k l $ d
outing	ng t I N
jaggier	_ { g nh R
approach	@ p r nf J
would	w U d
assurance	@ S $ r @ n s
churned	J nd n d
workhouse	w nd k h ng s
nearing	n nh r I N
bather	b nb D @ R
auricular	$ r I k j U l @ R
chortled	J $ t P d
thrombus	T r Q m b @ s
arrange	@ r nb n _
miscount	m I s k ng n t
headier	h E d nh R
leather	l E D @ R
petition	p @ t I S H
puma	p j u m @
miracles	m I r @ k P z
theorized	T nh r nc z d
occupied	Q k j U p nc d
giblets	_ I b l I t s
heard	h nd d
moused	m ng z d
seethe	s i D
lightened	l nc t H d
retched	r E J t
gargle	g # g P
health	h E l T
regulate	r E g j U l nb t
bevelled	b E v P d
shrinkage	S r I N k I _
curtailed	k nd t nb l d
polo	p nf l nf
rebel	r E b P
lather	l # D @ R
flayed	f l nb d
elicit	I l I s I t
dredged	d r E _ d
parsing	p # z I N
quarrying	k w Q r I I N
Plough	p l ng
disunite	d I s j u n nc t
frequent	f r I k w E n t
stencil	s t E n s P
closeted	k l Q z I t I d
curd	k nd d
sublease	s V b l i s
narcissus	n # s I s @ s
envy	E n v I
nineties	n nc n t I z
salivate	s { l I v nb t
healed	h i l d
drolly	d r nf l I
rootled	r u t P d
repainted	r i p nb n t I d
homonyms	h Q m nf n I m z
sinusitis	s nc n @ s nc t I s
weirdos	w nh d nf z
purchased	p nd J @ s t
straggled	s t r { g P d
rewired	r i w nc @ d
hatpins	h { t p I n z
piping	p nc p I N
toneless	t nf n l I s
Neptune	n E p t j u n
corundum	k @ r V n d @ m
markup	m # k V p
fault	f $ l t
bison	b nc s H
thawed	T $ d
Wedgwood	w E _ w U d
roused	r ng z d
near	n nh R
smoothed	s m u D d
seventy	s E v H t I
stepchild	s t E p J nc l d
thud	T V d
peculates	p E k j U l nb t s
apparel	@ p { r @ l
unholy	V n h nf l I
sprain	s p r nb n
certify	s nd t I f nc
shut	S V t
maundered	m $ n d @ d
hounded	h ng n d I d
muckier	m V k nh R
tethering	t E D @ r I N
irruption	I r V p S H
inch	I n J
atheistic	nb T I I s t I k
mournful	m $ n f U l
projector	p r @ _ E k t @ R
outcrop	ng t k r Q p
leered	l nh d
that	D { t
fashioned	f { S H d
match	m { J
methods	m E T @ d z
tegument	t E g j U m @ n t
vomited	v Q m I t I d
cadged	k { _ d
nighties	n nc t I z
conveners	k @ n v i n @ z
inch	I n J
handouts	h { n d ng t s
accent	{ k s E n t
retarded	r I t # d I d
desolates	d E s @ l nb t s
unstrung	V n s t r V N
dusting	d V s t I N
rammed	r { m d
Polly	p Q l I
curried	k V r I d
rummage	r V m I _
brownies	b r ng n I z
soignee	s w # n j nb
berthed	b nd T t
spiced	s p nc s t
hostile	h Q s t nc l
defy	d I f nc
those	D nf z
moonlight	m u n l nc t
grinding	g r nc n d I N
fatiguing	f @ t i g I N
exiled	E k s nc l d
filaments	f I l @ m @ n t s
forwarded	f $ w @ d I d
Zairean	z # nh r nh n
marathons	m { r @ T H z
copulate	k Q p j U l nb t
yang	j { N
stroke	s t r nf k
vegetable	v E _ t @ b P
travesty	t r { v @ s t I
ruin	r U I n
mollusc	m Q l @ s k
pretend	p r I t E n d
befoul	b I f ng l
dwelt	d w E l t
radiation	r nb d I nb S H
amphibian	{ m f I b nh n
nuzzle	n V z P
hyphens	h nc f H z
strongly	s t r Q N l I
integers	I n t I _ @ z
betwixt	b I t w I k s t
possessed	p @ z E s t
hover	h Q v @ R
outrode	ng t r nf d
chimes	J nc m z
allergic	@ l nd _ I k
waltz	w $ l s
that_QUOTE_s	D { t s
weeps	w i p s
recollect	r E k @ l E k t
creations	k r i nb S H z
inked	I N k t
replicate	r E p l I k nb t
miscarry	m I s k { r I
brain	b r nb n
trundling	t r V n d P I N
consign	k @ n s nc n
idealized	nc d nh l nc z d
char	J # R
embargo	E m b # g nf
deer	d nh R
strayed	s t r nb d
nosh	n Q S
accrued	@ k r u d
fattiest	f { t I I s t
sprang	s p r { N
canalized	k { n @ l nc z d
espoused	I s p ng z d
swindled	s w I n d P d
rule	r u l
abscesses	{ b s I s I z
collie	k Q l I
repentant	r I p E n t @ n t
ecstasy	E k s t @ s I
stuff	s t V f
bounder	b ng n d @ R
seminar	s E m I n # R
rhetoric	r E t @ r I k
saltlick	s $ l t l I k
certified	s nd t I f nc d
further	f nd D @ R
math	m { T
postulate	p Q s t j U l nb t
coddled	k Q d P d
active	{ k t I v
megaliths	m E g @ l I T s
spilled	s p I l d
cheeking	J i k I N
pronouns	p r nf n ng n z
underpay	V n d @ p nb
disabled	d I s nb b P d
barnacle	b # n @ k P
graduated	g r { d j U nb t I d
mnemonic	n i m Q n I k
snowball	s n nf b $ l
that	D { t
garnished	g # n I S t
mermen	m nd m E n
foxhound	f Q k s h ng n d
furbishes	f nd b I S I z
feedback	f i d b { k
hexed	h E k s t
treadled	t r E d P d
queenly	k w i n l I
numbered	n V m b @ d
hinted	h I n t I d
lampooned	l { m p u n d
curtain	k nd t H
divorce	d I v $ s
furthered	f nd D @ d
butcher	b U J @ R
breadth	b r E t T
bludgeons	b l V _ @ n z
interview	I n t @ v j u
guardsman	g # d z m @ n
crackled	k r { k P d
moseying	m nf z I I N
ingrained	I n g r nb n d
jawed	_ $ d
cheer	J nh R
withhold	w I D h nf l d
chastened	J nb s H d
threatens	T r E t H z
ambushed	{ m b U S t
peregrine	p E r I g r I n
Romanian	r u m nb n j @ n
junk	_ V N k
dirtied	d nd t I d
narrowed	n { r nf d
overcall	nf v @ k $ l
ruddier	r V d nh R
loathly	l nf D l I
threads	T r E d z
hooked	h U k t
moonlit	m u n l I t
munition	m j u n I S H
marten	m # t I n
vivas	v nc v @ z
mutilated	m j u t I l nb t I d
rock	r Q k
genitives	_ E n I t I v z
reign	r nb n
unseat	V n s i t
vanished	v { n I S t
calk	k $ k
orient	$ r nh n t
soothed	s u D d
chug	J V g
deaths	d E T s
pirouette	p I r U E t
flowered	f l ng @ d
nirvanas	n nh v # n @ z
scythes	s nc D z
roughened	r V f H d
champion	J { m p j @ n
thickener	T I k @ n @ R
retook	r i t U k
envisage	I n v I z I _
grade	g r nb d
razes	r nb z I z
broadcast	b r $ d k # s t
curs	k nd z
playhouse	p l nb h ng s
query	k w nh r I
smother	s m V D @ R
crimsons	k r I m z H z
clotures	k l nf J @ z
fortieths	f $ t I I T s
woefully	w nf f U l I
jollied	_ Q l I d
gurgled	g nd g P d
outplay	ng t p l nb
realized	r nh l nc z d
tether	t E D @ R
govern	g V v H
arches	# J I z
thumb	T V m
formulae	f $ m j U l i
jewels	_ u @ l z
inter	I n t nd R
plough	p l ng
impious	I m p nh s
thine	D nc n
leavened	l E v H d
chalky	J $ k I
wheedle	w i d P
filthier	f I l T nh R
hood	h U d
cheapjack	J i p _ { k
thirsted	T nd s t I d
cowskins	k ng s k I n z
writhed	r nc D d
widening	w nc d H I N
abuses	@ b j u s I z
scribble	s k r I b P
actuate	{ k t j U nb t
dredge	d r E _
whelp	w E l p
amok	@ m Q k
gravy	g r nb v I
butt	b V t
enfeebled	I n f i b P d
visaed	v i z @ d
Catherine	k { T @ r I n
unbend	V n b E n d
sexton	s E k s t @ n
suckle	s V k P
doeskin	d nf s k I n
personify	p @ s Q n I f nc
vexes	v E k s I z
waft	w # f t
buzz	b V z
taunt	t $ n t
avert	@ v nd t
flourmill	f l ng @ m I l
Cypriot	s I p r nh t
tether	t E D @ R
deadens	d E d H z
anchovy	{ n J @ v I
subjugate	s V b _ U g nb t
segregate	s E g r I g nb t
quadruply	k w Q d r U p l I
furrowing	f V r nf I N
tightened	t nc t H d
cactus	k { k t @ s
spoke	s p nf k
whirlwind	w nd l w I n d
boohoo	b u h u
nuttier	n V t nh R
naturists	n nb J @ r I s t s
ranchers	r # n J @ z
course	k $ s
crowd	k r ng d
then	D E n
vascular	v { s k j U l @ R
sheath	S i T
jemmied	_ E m I d
cubicles	k j u b I k P z
catfish	k { t f I S
trace	t r nb s
duped	d j u p t
hernias	h nd n j @ z
belittled	b I l I t P d
vocative	v Q k @ t I v
reinsured	r i I n S $ d
council	k ng n s P
clearout	k l nh r ng t
seaworthy	s i w nd D I
motion	m nf S H
bloodbath	b l V d b # T
lounge	l ng n _
fishcake	f I S k nb k
ingot	I N g @ t
loamy	l nf m I
weld	w E l d
fourteens	f $ t i n z
Bahamians	b @ h nb m nh n z
thus	D V s
softened	s Q f H d
chasten	J nb s H
earth	nd T
infatuate	I n f { t j U nb t
cogitate	k Q _ I t nb t
shillings	S I l I N z
waterfowl	w $ t @ f ng l
weirdness	w nh d n I s
withstood	w I D s t U d
pouched	p ng J t
thrillers	T r I l @ z
dodge	d Q _
solos	s nf l nf z
clarified	k l { r I f nc d
cuckoo	k U k u
boated	b nf t I d
bridge	b r I _
antecede	{ n t I s i d
cluck	k l V k
maraud	m @ r $ d
furnish	f nd n I S
eardrums	nh d r V m z
dither	d I D @ R
fashioned	f { S H d
flinched	f l I n J t
pencil	p E n s P
earthling	nd T l I N
adhere	@ d h nh R
profiteer	p r Q f I t nh R
shelved	S E l v d
pissed	p I s t
pirouette	p I r U E t
pities	p I t I z
composts	k Q m p Q s t s
about	@ b ng t
impassion	I m p { S H
guessed	g E s t
twines	t w nc n z
undercut	V n d @ k V t
designed	d I z nc n d
piracies	p nc @ r @ s I z
touchily	t V J I l I
prophesy	p r Q f I s nc
outbade	ng t b nb d
renounce	r I n ng n s
snuggle	s n V g P
jollied	_ Q l I d
whimpers	w I m p @ z
ossifies	Q s I f nc z
crick	k r I k
trimmest	t r I m I s t
misnomer	m I s n nf m @ R
gnawing	n $ I N
withers	w I D @ z
importune	I m p $ t j u n
thumbing	T V m I N
burned	b nd n d
scythe	s nc D
inherit	I n h E r I t
condition	k @ n d I S H
extenuate	I k s t E n j U nb t
lichgate	l I J g nb t
spangle	s p { N g P
threesome	T r i s @ m
generates	_ E n @ r nb t s
interlink	I n t @ l I N k
sojourn	s Q _ nd n
twofold	t u f nf l d
footman	f U t m @ n
slurped	s l nd p t
schooling	s k u l I N
agitating	{ _ I t nb t I N
Syrian	s I r nh n
doodled	d u d P d
debriefed	d i b r i f t
wreck	r E k
situated	s I t j U nb t I d
stoke	s t nf k
hover	h Q v @ R
sheepskin	S i p s k I n
dismantle	d I s m { n t P
aretes	@ r E t s
recapping	r i k { p I N
hotbeds	h Q t b E d z
might	m nc t
dramatize	d r { m @ t nc z
shinbone	S I n b nf n
quip	k w I p
syringed	s I r I n _ d
trustful	t r V s t f U l
gave	g nb v
dejected	d I _ E k t I d
rippling	r I p l I N
hoovered	h u v @ d
vesper	v E s p @ R
chafe	J nb f
cheapened	J i p @ n d
bypassed	b nc p # s t
pleasing	p l i z I N
demoted	d i m nf t I d
grab	g r { b
balding	b $ l d I N
fathered	f # D @ d
sevenths	s E v H T s
eyeglass	nc g l # s
grosser	g r nf s @ R
sear	s nh R
court	k $ t
sheathed	S i D d
orphan	$ f H
yacht	j Q t
theorized	T nh r nc z d
murder	m nd d @ R
outvotes	ng t v nf t s
clothed	k l nf D d
pheasants	f E z H t s
fabulous	f { b j U l @ s
chicken	J I k I n
drivel	d r I v P
eightieth	nb t nh T
jelly	_ E l I
stiffened	s t I f H d
swish	s w I S
deodorant	d i nf d @ r @ n t
scolded	s k nf l d I d
remainder	r I m nb n d @ R
father	f # D @ R
burthen	b nd D H
sleepiest	s l i p I I s t
tangle	t { N g P
inquiring	I n k w nc @ r I N
match	m { J
gullies	g V l I z
wrote	r nf t
flexed	f l E k s t
ossifies	Q s I f nc z
fell	f E l
oncoming	Q n k V m I N
legion	l i _ @ n
alexic	@ l E k s I k
overspill	nf v @ s p I l
valeted	v { l I t I d
gratified	g r { t I f nc d
crumbly	k r V m b l I
mystified	m I s t I f nc d
timothy	t I m @ T I
hosanna	h nf z { n @
chatter	J { t @ R
pacifier	p { s I f nc @ R
Bowie	b ng I
dawn	d $ n
cupid	k j u p I d
retraced	r I t r nb s t
drive	d r nc v
miscue	m I s k j u
jabber	_ { b @ R
shrugs	S r V g z
splodging	s p l Q _ I N
inquire	I n k w nc @ R
hundred	h V n d r @ d
lenity	l E n @ t I
glen	g l E n
motorize	m nf t @ r nc z
bedded	b E d I d
upped	V p t
sneeze	s n i z
Negro	n i g r nf
mince	m I n s
inductive	I n d V k t I v
swotters	s w Q t @ z
priceless	p r nc s l I s
trees	t r i z
edit	E d I t
misplace	m I s p l nb s
generated	_ E n @ r nb t I d
ropeway	r nf p w nb
Malayans	m @ l nb @ n z
flayed	f l nb d
implored	I m p l $ d
disperse	d I s p nd s
pounces	p ng n s I z
rear	r nh R
puzzles	p V z P z
thunder	T V n d @ R
prejudice	p r E _ U d I s
vamping	v { m p I N
gnash	n { S
moon	m u n
salad	s { l @ d
yawn	j $ n
partaking	p # t nb k I N
burthen	b nd D H
outnumber	ng t n V m b @ R
earmarked	nh m # k t
hiding	h nc d I N
pasture	p # s J @ R
nickel	n I k P
fiftieth	f I f t nh T
booklets	b U k l I t s
Chilean	J I l nh n
empty	E m p t I
fall	f $ l
whirl	w nd l
drown	d r ng n
smothered	s m V D @ d
offhand	Q f h { n d
ruction	r V k S H
regulo	r E g j U l nf
addles	{ d P z
toothier	t u T nh R
congers	k Q N g @ z
antelope	{ n t I l nf p
faugh	f $
splurges	s p l nd _ I z
outweigh	ng t w nb
mothered	m V D @ d
hulls	h V l z
flattens	f l { t H z
uterine	j u t @ r nc n
truncheon	t r V n J @ n
puddled	p V d P d
throb	T r Q b
modulated	m Q d j U l nb t I d
spied	s p nc d
erase	I r nb z
mania	m nb n j @
reprimand	r E p r I m # n d
salaamed	s @ l # m d
anaconda	{ n @ k Q n d @
torsos	t $ s nf z
spurt	s p nd t
brownie	b r ng n I
wreathes	r i D z
hazed	h nb z d
garden	g # d H
ditch	d I J
frivolled	f r I v P d
footbath	f U t b # T
compound	k @ m p ng n d
retake	r i t nb k
tattled	t { t P d
shirts	S nd t s
snort	s n $ t
crankier	k r { N k nh R
seethed	s i D d
dehorned	d i h $ n d
presences	p r E z H s I z
chubbier	J V b nh R
bathtub	b # T t V b
centuries	s E n J U r I z
unlearned	V n l nd n d
rehoused	r i h ng z d
further	f nd D @ R
crescent	k r E s H t
produced	p r @ d j u s t
fizzle	f I z P
thirds	T nd d z
simulated	s I m j U l nb t I d
jolly	_ Q l I
triumph	t r nc @ m f
nasality	n nb z { l @ t I
qualify	k w Q l I f nc
precis	p r nb s i
defectors	d I f E k t @ z
gulled	g V l d
conversed	k @ n v nd s t
mosey	m nf z I
stabilize	s t nb b @ l nc z
shook	S U k
Hesse	h E s I
elated	I l nb t I d
embedded	I m b E d I d
tilled	t I l d
antipodes	{ n t I p @ d i z
swimmers	s w I m @ z
parrot	p { r @ t
mishandle	m I s h { n d P
protruded	p r @ t r u d I d
thatched	T { J t
broadside	b r $ d s nc d
wound	w ng n d
stodgier	s t Q _ nh R
dithering	d I D @ r I N
certainty	s nd t H t I
revivify	r i v I v I f nc
dewponds	d j u p Q n d z
snortier	s n $ t nh R
hourglass	ng @ g l # s
algorithm	{ l g @ r I D @ m
buttons	b V t H z
fluctuate	f l V k J U nb t
hassle	h { s P
cathartic	k @ T # t I k
hewed	h j u d
mendacity	m E n d { s @ t I
cuisine	k w I z i n
cease	s i s
soured	s ng @ d
bamboo	b { m b u
inferred	I n f nd d
disposal	d I s p nf z P
devils	d E v P z
minced	m I n s t
obliged	@ b l nc _ d
iodized	nc nf d nc z d
overstate	nf v @ s t nb t
chided	J nc d I d
hurried	h V r I d
roared	r $ d
lineally	l I n nh l I
brethren	b r E D r @ n
pardon	p # d H
throb	T r Q b
doubtful	d ng t f U l
worsted	w nd s t I d
mollify	m Q l I f nc
raided	r nb d I d
idem	nc d E m
align	@ l nc n
grumbles	g r V m b P z
ratifying	r { t I f nc I N
coiffeurs	k w # f nd z
hurrah	h U r #
bruised	b r u z d
stuffed	s t V f t
outlast	ng t l # s t
driblet	d r I b l I t
couth	k u T
iambi	nc { m b nc
fastens	f # s H z
healing	h i l I N
smithies	s m I D I z
prosaic	p r nf z nb I k
babble	b { b P
queened	k w i n d
admix	{ d m I k s
twelve	t w E l v
pallets	p { l I t s
dialled	d nc @ l d
jagged	_ { g I d
sledding	s l E d I N
precise	p r I s nc s
chimneys	J I m n I z
lease	l i s
indent	I n d E n t
sidestep	s nc d s t E p
travelled	t r { v P d
fowled	f ng l d
rankled	r { N k P d
maim	m nb m
deported	d I p $ t I d
creosote	k r nh s nf t
misuse	m I s j u z
junk	_ V N k
gaffed	g { f t
atelier	@ t E l I nb
knapped	n { p t
malted	m $ l t I d
transient	t r { n z nh n t
blethered	b l E D @ d
ravened	r { v H d
enumerate	I n j u m @ r nb t
cheerless	J nh l I s
earthwork	nd T w nd k
crooked	k r U k t
outspoken	ng t s p nf k @ n
miaowed	m i ng d
educed	i d j u s t
sincerer	s I n s nh r @ R
sandier	s { n d nh R
cubing	k j u b I N
knackered	n { k @ d
mammals	m { m P z
deities	d i I t I z
darted	d # t I d
layman	l nb m @ n
tenacity	t I n { s @ t I
teetered	t i t @ d
flounder	f l ng n d @ R
snooped	s n u p t
rollicked	r Q l I k t
crash	k r { S
sensed	s E n s t
videos	v I d I nf z
expose	I k s p nf z
propose	p r @ p nf z
bouncing	b ng n s I N
sprained	s p r nb n d
bloom	b l u m
Boer	b $ R
feather	f E D @ R
roughened	r V f H d
chance	J # n s
filthiest	f I l T I I s t
tuneful	t j u n f U l
mortgaged	m $ g I _ d
lathe	l nb D
coarsened	k $ s H d
chivied	J I v I d
theocrat	T nh k r { t
evacuate	I v { k j U nb t
educable	E _ U k @ b P
forgather	f $ g { D @ R
unhooking	V n h U k I N
flattened	f l { t H d
pouch	p ng J
motions	m nf S H z
pith	p I T
trudges	t r V _ I z
loathsome	l nf D s @ m
horseman	h $ s m @ n
watches	w Q J I z
chutes	S u t s
dethroned	d I T r nf n d
allergies	{ l @ _ I z
kirk	k nd k
armorial	# m $ r nh l
thus	D V s
heronry	h E r @ n r I
cautioned	k $ S H d
communism	k Q m j U n I z @ m
achieve	@ J i v
threnody	T r E n @ d I
encourage	I n k V r I _
spurred	s p nd d
souvenirs	s u v @ n nh z
teethed	t i D d
hollered	h Q l @ d
gentian	_ E n S H
cranial	k r nb n j @ l
chaw	J $
crinkled	k r I N k P d
throwaway	T r nf @ w nb
footstep	f U t s t E p
purpler	p nd p P @ R
bout	b ng t
nirvanas	n nh v # n @ z
swathed	s w nb D d
harden	h # d H
repute	r I p j u t
chooses	J u z I z
reissued	r i I S u d
apathetic	{ p @ T E t I k
cooker	k U k @ R
savage	s { v I _
curs	k nd z
outlasts	ng t l # s t s
besmeared	b I s m nh d
farthest	f # D I s t
diehards	d nc h # d z
tighten	t nc t H
acuteness	@ k j u t n I s
chip	J I p
mumble	m V m b P
splash	s p l { S
dethrones	d I T r nf n z
refoot	r i f U t
ingestion	I n _ E s J @ n
gybe	_ nc b
awakened	@ w nb k @ n d
stir	s t nd R
orientate	$ r I E n t nb t
downed	d ng n d
hosiers	h nf z nh z
withheld	w I D h E l d
arson	# s H
pursues	p @ s j u z
finable	f nc n @ b P
Martians	m # S H z
fourthly	f $ T l I
pushed	p U S t
curled	k nd l d
endowing	I n d ng I N
clear	k l nh R
feathers	f E D @ z
continued	k @ n t I n j u d
chilled	J I l d
cancels	k { n s P z
tholes	T nf l z
woollier	w U l nh R
ravage	r { v I _
sophistry	s Q f I s t r I
kinking	k I N k I N
made	m nb d
clucking	k l V k I N
foul	f ng l
skived	s k nc v d
hourglass	ng @ g l # s
attorn	@ t nd n
estrange	I s t r nb n _
master_QUOTE_s	m # s t @ z
sleetier	s l i t nh R
coincide	k nf I n s nc d
sandbag	s { n d b { g
twist	t w I s t
recalled	r I k $ l d
dithered	d I D @ d
heeled	h i l d
sudden	s V d H
yacht	j Q t
champs	J { m p s
bugled	b j u g P d
anxious	{ N k S @ s
thieves	T i v z
betook	b I t U k
boarded	b $ d I d
preserved	p r I z nd v d
clothe	k l nf D
haft	h # f t
loosens	l u s H z
butch	b U J
pickles	p I k P z
ambush	{ m b U S
thrum	T r V m
jots	_ Q t s
collate	k @ l nb t
palavered	p @ l # v @ d
exert	I g z nd t
kurus	k U r U S
galled	g $ l d
aroused	@ r ng z d
teensier	t i n z nh R
wreaths	r i D z
homing	h nf m I N
emissions	I m I S H z
acidulate	@ s I d j U l nb t
captures	k { p J @ z
battle	b { t P
fourthly	f $ T l I
envisaged	I n v I z I _ d
reworded	r i w nd d I d
doubter	d ng t @ R
enviable	E n v nh b P
tether	t E D @ R
headed	h E d I d
Venetian	v @ n i S H
newsflash	n j u z f l { S
branch	b r # n J
wroth	r nf T
adjunct	{ _ V N k t
hied	h nc d
trims	t r I m z
dumbbells	d V m b E l z
layers	l nb @ z
piggybank	p I g I b { N k
stencil	s t E n s P
criticize	k r I t I s nc z
jaywalked	_ nb w $ k t
Burmese	b nd m i z
outfitted	ng t f I t I d
Algerians	{ l _ nh r nh n z
smoothed	s m u D d
donations	d nf n nb S H z
rescues	r E s k j u z
drenches	d r E n J I z
bathed	b # T t
dowry	d ng @ r I
drain	d r nb n
Sicilian	s I s I l j @ n
declutch	d i k l V J
sweetens	s w i t H z
gradation	g r @ d nb S H
shelled	S E l d
slatings	s l nb t I N z
pouching	p ng J I N
bream	b r i m
befriend	b I f r E n d
revolved	r I v Q l v d
snookers	s n u k @ z
extradite	E k s t r @ d nc t
calked	k $ k t
smirked	s m nd k t
furthered	f nd D @ d
hastily	h nb s t I l I
shambles	S { m b P z
therapy	T E r @ p I
capstan	k { p s t @ n
rumbles	r V m b P z
payers	p nb @ z
links	l I N k s
lobby	l Q b I
reared	r nh d
lockjaw	l Q k _ $
bypaths	b nc p # D z
hive	h nc v
modulate	m Q d j U l nb t
leviathan	l I v nc @ T H
bridle	b r nc d P
whang	w { N
pipped	p I p t
addicting	@ d I k t I N
ponder	p Q n d @ R
league	l i g
pearlier	p nd l nh R
overhead	nf v @ h E d
quartet	k w $ t E t
scoured	s k ng @ d
smother	s m V D @ R
Yemenis	j E m @ n I z
hunched	h V n J t
beneath	b I n i T
workrooms	w nd k r U m z
Virginia	v @ _ I n j @
shrink	S r I N k
sent	s E n t
pike	p nc k
renames	r i n nb m z
cites	s nc t s
inducted	I n d V k t I d
curtained	k nd t H d
adorned	@ d $ n d
scowled	s k ng l d
summerier	s V m @ r nh R
withstand	w I D s t { n d
stanched	s t # n J t
crinkle	k r I N k P
thank	T { N k
simulated	s I m j U l nb t I d
largest	l # _ I s t
chaps	J { p s
raspberry	r # z b @ r I
Paraclete	p { r @ k l i t
climax	k l nc m { k s
fined	f nc n d
liquefied	l I k w I f nc d
silences	s nc l @ n s I z
succumb	s @ k V m
madhouse	m { d h ng s
worship	w nd S I p
decode	d i k nf d
rejected	r I _ E k t I d
high	h nc
aurally	$ r @ l I
inferiors	I n f nh r nh z
withheld	w I D h E l d
woodenly	w U d H l I
ripple	r I p P
thrill	T r I l
jilt	_ I l t
torques	t $ k s
outed	ng t I d
withheld	w I D h E l d
gladdened	g l { d H d
Canadian	k @ n nb d j @ n
checkers	J E k @ z
spangled	s p { N g P d
math	m { T
would	w U d
bristle	b r I s P
unhand	V n h { n d
renew	r I n j u
bankers	b { N k @ z
blasted	b l # s t I d
induced	I n d j u s t
peppered	p E p @ d
governed	g V v H d
ravished	r { v I S t
skyward	s k nc w @ d
whimpered	w I m p @ d
wandered	w Q n d @ d
clash	k l { S
lionize	l nc @ n nc z
tickled	t I k P d
potable	p nf t @ b P
Whitsun	w I t s H
offering	Q f @ r I N
peeved	p i v d
encumbers	I n k V m b @ z
clamp	k l { m p
succumb	s @ k V m
abhorrent	@ b h Q r @ n t
dearer	d nh r @ R
envyingly	E n v I I N l I
millet	m I l I t
power	p ng @ R
necklace	n E k l I s
reverse	r I v nd s
wires	w nc @ z
cool	k u l
hotpot	h Q t p Q t
reproofed	r i p r u f t
tensing	t E n s I N
mustiness	m V s t I n I s
carried	k { r I d
unkinder	V n k nc n d @ R
arrest	@ r E s t
blanket	b l { N k I t
caboodle	k @ b u d P
profess	p r @ f E s
postured	p Q s J @ d
abrade	@ b r nb d
jump	_ V m p
bedsides	b E d s nc d z
puzzle	p V z P
reckons	r E k @ n z
gibbeted	_ I b I t I d
Ethiopian	i T I nf p j @ n
drew	d r u
withdraw	w I D d r $
butchers	b U J @ z
surmised	s nd m nc z d
inmates	I n m nb t s
herewith	h nh w I D
rinse	r I n s
suiting	s u t I N
triumphed	t r nc @ m f t
violent	v nc @ l @ n t
distorted	d I s t $ t I d
encounter	I n k ng n t @ R
thrill	T r I l
stateroom	s t nb t r U m
awake	@ w nb k
kilohertz	k i l nf h nd t s
discount	d I s k ng n t
scheme	s k i m
heave	h i v
cascaded	k { s k nb d I d
prepacks	p r i p { k s
pule	p j u l
tamps	t { m p s
spurred	s p nd d
stagnated	s t { g n nb t I d
darken	d # k @ n
permeable	p nd m j @ b P
avouching	@ v ng J I N
proceeded	p r @ s i d I d
clone	k l nf n
perm	p nd m
hurls	h nd l z
freewill	f r i w I l
vivisect	v I v I s E k t
funnelled	f V n P d
rhapsody	r { p s @ d I
dripped	d r I p t
stalemate	s t nb l m nb t
fence	f E n s
protests	p r nf t E s t s
away	@ w nb
token	t nf k @ n
euclidean	j u k l I d nh n
pantheism	p { n T i I z @ m
puniest	p j u n I I s t
hauteur	nf t nd R
aped	nb p t
latitudes	l { t I t j u d z
buttoned	b V t H d
undone	V n d V n
iodizes	nc nf d nc z I z
winced	w I n s t
heckled	h E k P d
ground	g r ng n d
crow	k r nf
inches	I n J I z
feathered	f E D @ d
meseems	m I s i m z
bargee	b # _ i
betokened	b I t nf k @ n d
replied	r I p l nc d
suspect	s V s p E k t
clown	k l ng n
bellowing	b E l nf I N
foreboded	f $ b nf d I d
buffet	b U f nb
filtrate	f I l t r nb t
hellos	h @ l nf z
dirty	d nd t I
chipboard	J I p b $ d
emirs	E m nh z
breathe	b r i D
soften	s Q f H
shag	S { g
locksmith	l Q k s m I T
womanized	w U m @ n nc z d
widgeons	w I _ @ n z
nicknamed	n I k n nb m d
litigates	l I t I g nb t s
jovially	_ nf v j @ l I
lavishly	l { v I S l I
sporrans	s p Q r @ n z
sniping	s n nc p I N
taxation	t { k s nb S H
sicken	s I k @ n
artifice	# t I f I s
tarrier	t # r nh R
credulity	k r I d j u l @ t I
deputize	d E p j U t nc z
hibernate	h nc b @ n nb t
talk	t $ k
mouthed	m ng D d
monthly	m V n T l I
heights	h nc t s
scupper	s k V p @ R
viscounts	v nc k ng n t s
bridled	b r nc d P d
enliven	I n l nc v H
weeds	w i d z
redirects	r i d I r E k t s
jump	_ V m p
beggar	b E g @ R
focus	f nf k @ s
deodars	d I nf d # z
Yugoslav	j u g nf s l # v
moulder	m nf l d @ R
nubs	n V b z
screw	s k r u
jailer	_ nb l @ R
pattens	p { t H z
sixths	s I k s T s
smile	s m nc l
clingy	k l I N I
mould	m nf l d
trappings	t r { p I N z
tousle	t ng z P
mumble	m V m b P
insist	I n s I s t
calyces	k nb l I k s I z
zippy	z I p I
dwelling	d w E l I N
flipper	f l I p @ R
warped	w $ p t
neared	n nh d
southerly	s V D @ l I
hunches	h V n J I z
uvulars	j u v j U l @ z
yellowest	j E l nf I s t
feudal	f j u d P
deduct	d I d V k t
comment	k Q m E n t
hardened	h # d H d
snipped	s n I p t
deforest	d i f Q r I s t
seventeen	s E v H t i n
sandals	s { n d P z
scruple	s k r u p P
shelduck	S E l d V k
meantime	m i n t nc m
entreated	I n t r i t I d
doubter	d ng t @ R
jiggled	_ I g P d
rerun	r i r V n
effluxes	E f l V k s I z
cadge	k { _
popinjay	p Q p I n _ nb
absolute	{ b s @ l u t
parvenus	p # v @ n j u z
cagier	k nb _ nh R
shirk	S nd k
scorebook	s k $ b U k
smoothed	s m u D d
catch	k { J
monolith	m Q n nf l I T
keen	k i n
crossbred	k r Q s b r E d
noblemen	n nf b P m @ n
tinplate	t I n p l nb t
imbeciles	I m b I s i l z
shooed	S u d
scapula	s k { p j U l @
wrestler	r E s l @ R
cudgelled	k V _ @ l d
telexed	t E l E k s t
groaned	g r nf n d
purchaser	p nd J @ s @ R
rapacity	r @ p { s @ t I
pituitary	p I t j U I t @ r I
loosest	l u s I s t
tomahawk	t Q m @ h $ k
Elysian	I l I z nh n
neither	n nc D @ R
froth	f r Q T
barbarize	b # b @ r nc z
skip	s k I p
wrecks	r E k s
crucifix	k r u s I f I k s
fervently	f nd v @ n t l I
pinned	p I n d
wackiness	w { k I n I s
muted	m j u t I d
wheedling	w i d P I N
meant	m E n t
astride	@ s t r nc d
brazing	b r nb z I N
canton	k { n t Q n
ingrain	I n g r nb n
recharge	r i J # _
keeper	k i p @ R
reunions	r i j u n j @ n z
murmured	m nd m @ d
oxen	Q k s @ n
squired	s k w nc @ d
ethereal	I T nh r nh l
monkey	m V N k I
passkeys	p # s k i z
arises	@ r nc z I z
likely	l nc k l I
chub	J V b
fomenting	f nf m E n t I N
purr	p nd R
quagga	k w { g @
ached	nb k t
jetted	_ E t I d
recited	r I s nc t I d
cawed	k $ d
withers	w I D @ z
laments	l @ m E n t s
embattled	I m b { t P d
stated	s t nb t I d
patterned	p { t @ n d
pillaged	p I l I _ d
gelling	_ E l I N
jollified	_ Q l I f nc d
discard	d I s k # d
debagged	d i b { g d
smirking	s m nd k I N
dated	d nb t I d
abrogated	{ b r nf g nb t I d
lounged	l ng n _ d
charnel	J # n P
cerebrate	s E r I b r nb t
attested	@ t E s t I d
droop	d r u p
skylarked	s k nc l # k t
barbarous	b # b @ r @ s
snag	s n { g
crappiest	k r { p I I s t
involve	I n v Q l v
bushy	b U S I
disclosed	d I s k l nf z d
kappa	k { p @
saplings	s { p l I N z
diversely	d nc v nd s l I
misspent	m I s s p E n t
tormentor	t $ m E n t @ R
leather	l E D @ R
klaxons	k l { k s H z
pantheist	p { n T i I s t
astounded	@ s t ng n d I d
traffic	t r { f I k
manometer	m @ n Q m I t @ R
chafed	J nb f t
laundered	l $ n d @ d
mishear	m I s h nh R
worthier	w nd D nh R
incessant	I n s E s H t
shinned	S I n d
rethink	r i T I N k
tootsies	t U t s I z
oxidize	Q k s I d nc z
ankles	{ N k P z
nattiest	n { t I I s t
gondola	g Q n d @ l @
skimmed	s k I m d
sledges	s l E _ I z
blazoned	b l nb z H d
reprisals	r I p r nc z P z
rentable	r E n t @ b P
padlocks	p { d l Q k s
release	r I l i s
initials	I n I S P z
spurn	s p nd n
tacked	t { k t
fattened	f { t H d
awfulness	$ f U l n I s
withdrew	w I D d r u
bimonthly	b nc m V n T l I
amass	@ m { s
obsess	@ b s E s
nudge	n V _
Dutchman	d V J m @ n
tabooed	t @ b u d
noosed	n u s t
mused	m j u z d
freshness	f r E S n I s
predigest	p r i d nc _ E s t
live	l I v
soldiered	s nf l _ @ d
tussocks	t V s @ k s
evicted	I v I k t I d
crawling	k r $ l I N
highbrows	h nc b r ng z
biers	b nh z
smoothest	s m u D I s t
thumbnail	T V m n nb l
wolf	w U l f
recanted	r I k { n t I d
gods	g Q d z
miaow	m i ng
blur	b l nd R
maple	m nb p P
relocates	r i l nf k nb t s
creoles	k r i nf l z
buttery	b V t @ r I
wanked	w { N k t
checked	J E k t
acquittal	@ k w I t P
yanking	j { N k I N
backchat	b { k J { t
dally	d { l I
agenda	@ _ E n d @
mulch	m V l J
Boers	b $ z
bandier	b { n d nh R
they_QUOTE_d	D nb d
gardened	g # d H d
Mauritian	m @ r I S H
thwarted	T w $ t I d
fluctuate	f l V k J U nb t
scowl	s k ng l
sneer	s n nh R
fathom	f { D @ m
unleashed	V n l i S t
Sabbaths	s { b @ T s
cushioned	k U S H d
snow	s n nf
scrawl	s k r $ l
anyhow	E n I h ng
sneerer	s n nh r @ R
withheld	w I D h E l d
thieved	T i v d
pulpit	p U l p I t
mafficked	m { f I k t
embezzles	I m b E z P z
rainy	r nb n I
guzzle	g V z P
cobble	k Q b P
poached	p nf J t
stumbled	s t V m b P d
sluiced	s l u s t
tribune	t r I b j u n
Tswanas	t s w # n @ z
cream	k r i m
miserable	m I z @ r @ b P
sluices	s l u s I z
metros	m E t r nf z
offside	Q f s nc d
socked	s Q k t
effigies	E f I _ I z
daubing	d $ b I N
how_QUOTE_s	h ng z
requiem	r E k w nh m
bother	b Q D @ R
pythons	p nc T H z
thrashes	T r { S I z
youthful	j u T f U l
fetch	f E J
instep	I n s t E p
beadiest	b i d I I s t
contused	k @ n t j u z d
direct	d I r E k t
rumble	r V m b P
resin	r E z I n
hector	h E k t @ R
peacetime	p i s t nc m
canker	k { N k @ R
totally	t nf t P I
asked	# s k t
creep	k r i p
scabbards	s k { b @ d z
misruled	m I s r u l d
blabbed	b l { b d
overrate	nf v @ r nb t
vitreous	v I t r nh s
shrilling	S r I l I N
better	b E t @ R
firsts	f nd s t s
reinsured	r i I n S $ d
pouched	p ng J t
bother	b Q D @ R
harmattan	h # m { t H
foot	f U t
waft	w # f t
need	n i d
splotched	s p l Q J t
peekaboo	p i k @ b u
slashed	s l { S t
poked	p nf k t
lackeys	l { k I z
pederasts	p E d @ r { s t s
startle	s t # t P
bathing	b nb D I N
ossify	Q s I f nc
lance	l # n s
Greenwich	g r E n I _
intercoms	I n t @ k Q m z
examined	I g z { m I n d
iodized	nc nf d nc z d
exempt	I g z E m p t
shaved	S nb v d
kolas	k nf l @ z
crayoning	k r nb @ n I N
ibises	nc b I s I z
trust	t r V s t
girds	g nd d z
spikenard	s p nc k n # d
ships	S I p s
rescinded	r I s I n d I d
neither	n nc D @ R
restored	r I s t $ d
outback	ng t b { k
magnesium	m { g n i z nh m
orphans	$ f H z
Rwandans	r U { n d @ n z
tousled	t ng z P d
salvia	s { l v nh
monotony	m @ n Q t H I
thrifty	T r I f t I
hook	h U k
brook	b r U k
spirited	s p I r I t I d
moon	m u n
roods	r u d z
sides	s nc d z
roentgen	r Q n t j @ n
pitchfork	p I J f $ k
allowed	@ l ng d
suppliant	s V p l nh n t
they_QUOTE_d	D nb d
govern	g V v H
fifteenth	f I f t i n T
orgasmic	$ g { z m I k
expertly	E k s p nd t l I
expound	I k s p ng n d
appear	@ p nh R
tether	t E D @ R
unbidden	V n b I d H
throttled	T r Q t P d
footslog	f U t s l Q g
clip	k l I p
skim	s k I m
cambered	k { m b @ d
tame	t nb m
pitifully	p I t I f U l I
dropkicks	d r Q p k I k s
rewire	r i w nc @ R
mimed	m nc m d
tied	t nc d
